Gg, Aa, Rr, Gg, Rr, Rr, Gg, Gg, Gg, Hh, Gg, Gg, Rr, Gs^Fp, Gs^Fp, Gs^Fp, Gg, Gg, Gg, Gg, Gg, Gg, Gg, Gg, Gg, Gg, Gg, Gg, Gg, Gg, Gg, Gg, Gg, Rr, Rr, Rr, Gs^Fp, Gs^Fp, Hh, Hh, Hh, Ww
Gg, Rr, Gg, Rr, Gg, Gg, Gg, Aa, Gg, Hh, Hh, Gg, Rr, Gg, Gg, Gg, Gg, Gg, Gg, Aa, Aa, Ds, Ds, Gg, Gs^Fp, Gg, Gg, Gs^Fp, Gs^Fp, Gg, Gg, Gg, Gg, Rr, Rr, Rr, Gs^Fp, Hh, Ww, Ww, Ww, Ww
Rr, Rr, Gg, Gg, Gs^Fp, Gs^Fp, Gg, Gg, Gg, Hh, Hh, Gg, Rr, Gg, Gg, Gg, Gg, Gg, Gg, Aa, Aa, Aa, Ds, Ds, Gg, Gg, Gg, Gs^Fp, Gs^Fp, Gs^Fp, Gg, Gg, Gg, Rr, Rr, Gg, Hh, Hh, Ww, Ww, Ww, Ww
Gg, Gg, Gg, Ds, Ww, Gs^Fp, Gs^Fp, Gg, Gg, Gg, Gg, Rr, Gg^Ve, Gs^Fp, Gg, Gg, Gg, Gg, Aa, Gg, Aa, Aa, Gg, Gg, Gg, Gg, Gs^Fp, Gg^Ve, Gs^Fp, Gg, Gg, Gg, Rr, Rr, Aa, Ch, Ch, Ch, Mm, Ww, Ww, Ww
Gs^Fp, Gg, Gg^Vh, Ds, Wo, Ww, Gs^Fp, Gg, Gg, Gg, Rr, Rr, Gs^Fp, Gs^Fp, Gs^Fp, Gg, Gg, Gg, Aa, Aa, Aa, Gg, Gg, Gg, Gg, Gg, Rr, Rr, Rr, Gg, Rr, Rr, Gg, Aa, Aa, Ch, 2 Kh, Ch, Mm, Ww, Ww, Ww
Ss, Ds, Ds, Ww, Wo, Ww, Ww, Gg, Gg, Gg, Rr, Gs^Fp, Gs^Fp, Ss, Gs^Fp, Gg^Ve, Gg, Gg, Aa, Aa, Gg, Gg, Rr, Rr, Rr, Rr, Gg, Hh, Hh, Rr, Gg, Gg, Gg, Aa, Ch, Ch, Ch, Gs^Fp, Mm, Ww, Ww, Ww
Ds, Ww, Ww, Ww, Ds, Ww, Gg, Ww, Ww, Ch, Ww, Gs^Fp, Ss, Ss, Gg, Gs^Fp, Gg, Gg, Gg, Gg, Gg, Gg, Rr, Gg, Gg, Gg, Gg, Gg, Gg, Gg, Gs^Fp, Gg, Gg, Gg, Aa, Rr, Gg, Gg, Gs^Fp, Hh, Mm, Mm
Ds, Ds, Ds, Ds, Ds, Gg, Gg, Ww, Ds, Rr, Ww, Gs^Fp, Ss, Ss, Gg, Gs^Fp, Gg, Gg, Aa, Gg, Rr, Rr, Gg, Gs^Fp, Gg, Gg, Gg, Gg, Rr, Gg, Rr, Gs^Fp, Rr, Rr, Aa, Rr, Gg, Gg, Gg, Gg^Vh, Hh, Hh
Ds, Ss, Gs^Fp, Gg, Gg, Gg, Gs^Fp, Gg, Gg, Rr, Ww, Gs^Fp, Gs^Fp, Gg, Gg, Gg, Gs^Fp, Gg, Rr, Rr, Gg, Gg, Gs^Fp, Gs^Fp, Gs^Fp, Gg, Gg, Rr, Gg, Rr, Gg^Vh, Rr, Gg, Gg, Aa, Rr, Gg, Gs^Fp, Gs^Fp, Gg, Gg, Gg
Gs^Fp, Gs^Fp, Gs^Fp, Gs^Fp, Gg, Gs^Fp, Gs^Fp, Gs^Fp, Gs^Fp, Rr, Ww, Gg, Gs^Fp, Gs^Fp, Gg, Gs^Fp, Gs^Fp, Gg, Rr, Aa, Gg, Gg, Gg, Gg^Ve, Gs^Fp, Gg, Gg, Rr, Gg, Gg, Gg, Gg, Gg, Gg, Aa, Rr, Rr, Gg^Ve, Gs^Fp, Gg, Gg, Gg
Gg, Gg, Gs^Fp, Gs^Fp, Gs^Fp, Gs^Fp, Ss, Gs^Fp, Gs^Fp, Rr, Ww, Gg, Gg, Gs^Fp, Gs^Fp, Gs^Fp, Gg, Gg, Rr, Aa, Gg, Gg, Gg, Gs^Fp, Gs^Fp, Gg, Rr, Rr, Gg, Gg, Gg, Gg, Gg, Gg, Gg, Gg, Rr, Gs^Fp, Gg, Gg, Gg, Gg
Gg, Gg, Gs^Fp, Gg^Ve, Gs^Fp, Gs^Fp, Gg, Gs^Fp, Rr, Rr, Ww, Gg, Gg, Gg, Gs^Fp, Gg, Rr, Rr, Aa, Aa, Gg, Gg, Gg, Gg, Rr, Rr, Gg, Gg, Ds, Gg, Gg, Gg, Gg, Gg, Gg, Gg, Gs^Fp, Rr, Gg, Gg, Gs^Fp, Gs^Fp
Gs^Fp, Gg, Gs^Fp, Gs^Fp, Gs^Fp, Gs^Fp, Rr, Rr, Gg, Gg^Vh, Ww, Gg, Gg, Gg, Gg, Gg, Rr, Gg, Gg, Gg, Gg, Gg, Rr, Rr, Gg, Gg, Gg, Gg, Gg, Gg, Gg, Gg, Gg, Gg, Gg, Gg, Gg, Rr, Rr, Gg, Gs^Fp, Gs^Fp
Gs^Fp, Gg, Gg, Gg, Rr, Rr, Gg, Gg, Gg, Gg, Ww, Gg, Gg, Gg, Rr, Rr, Gg, Aa, Rr, Rr, Rr, Rr, Gg, Gs^Fp, Gg, Gg, Gs^Fp, Gs^Fp, Ds, Gg, Gg, Gg, Gg, Gg, Gg, Gg, Gg, Gg, Gg, Rr, Rr, Gs^Fp
Gs^Fp, Gg, Gg, Rr, Gg, Gg, Gg, Gg, Gg, Gg, Ww, Gg, Hh, Gg, Rr, Gg^Vh, Gg, Gg, Rr, Gs^Fp, Gg^Ve, Gs^Fp, Gs^Fp, Gs^Fp, Gs^Fp, Gs^Fp, Gs^Fp, Gg^Ve, Gs^Fp, Gs^Fp, Gg, Gg, Gg, Aa, Gg, Hh, Gg, Gg, Gg, Gg, Gg, Rr
Gg, Gg, Rr, Rr, Aa, Aa, Aa, Aa, Gg, Gg, Ww, Gg, Rr, Hh, Rr, Gg, Gg, Gg, Rr, Gs^Fp, Gs^Fp, Gs^Fp, Gs^Fp, Gs^Fp, Gs^Fp, Gs^Fp, Gs^Fp, Gs^Fp, Gs^Fp, Gs^Fp, Gg, Gg, Gg, Ha, Ha, Gg, Gg^Vh, Gg, Gg, Gg, Gg^Vh, Rr
Gg, Gg, Rr, Aa, Aa, Aa, Aa, Gg, Ww, Ww, Rr, Rr, Gs^Fp, Rr, Hh, Gg, Gg, Gg, Rr, Gs^Fp, Ss, Gg, Gg, Gs^Fp, Gs^Fp, Gs^Fp, Gg^Ve, Gs^Fp, Gs^Fp, Gs^Fp, Gs^Fp, Hh, Hh, Ha, Ha, Hh, Gg, Gg, Gg, Gg, Gs^Fp, Rr
Rr, Aa, Aa, Aa, Aa, Aa, Aa, Gg, Ww^Bw/, Rr, Gs^Fp, Gs^Fp, Gs^Fp, Gs^Fp, Gs^Fp, Gs^Fp, Gs^Fp, Rr, Gs^Fp, Gg, Ss, Gg, Gg, Gg, Gg, Gs^Fp, Gs^Fp, Gs^Fp, Gs^Fp, Gs^Fp, Hh, Hh, Hh, Ha, Ha, Hh, Gg, Gg, Gg, Gg, Gg, Gs^Fp
Rr, Aa, Gg, Gg, Rr, Rr, Rr, Rr, Ww, Gs^Fp, Gs^Fp, Gs^Fp, Gs^Fp, Gs^Fp, Gs^Fp, Gs^Fp, Gg, Rr, Gg, Gs^Fp, Gg, Gg, Gg, Gg, Gg, Gs^Fp, Gs^Fp, Gs^Fp, Gs^Fp, Gs^Fp, Hh, Hh, Hh, Hh, Hh, Gg, Gg, Gg, Gg, Gg, Gg, Gg
Rr, Aa, Rr, Rr, Gs^Fp, Hh, Ww, Ww, Ww, Gg^Vh, Gs^Fp, Gs^Fp, Gs^Fp, Gs^Fp, Gs^Fp, Gs^Fp, Gg^Vh, Rr, Gg, Gg, Gs^Fp, Gg, Gg, Gg, Gg, Gs^Fp, Gs^Fp, Gg, Gg, Gs^Fp, Gg, Hh, Hh, Hh, Gg, Gg, Gg, Gg, Gg, Gg, Gg, Gg
Aa, Aa, Gg, Gg^Vh, Gs^Fp, Gs^Fp, Ww, Ww, Ww, Gg, Gg, Gg, Gg, Gs^Fp, Gg, Gg, Gg, Rr, Gg, Gg, Gs^Fp, Gg, Gg, Gg, Gg, Gs^Fp, Gg, Gg, Gg, Gs^Fp, Gs^Fp, Gs^Fp, Gg, Gg, Gg, Gg, Gg, Gg, Gg, Gg, Gg, Gg
Aa, Aa, Gg, Gg, Gg, Ww, Ww, Ww, Ww, Gg, Gg, Gg, Gg, Gg, Gg, Gg, Gg, Rr, Gs^Fp, Gg, Gs^Fp, Gs^Fp, Gs^Fp, Gs^Fp, Gs^Fp, Gs^Fp, Gs^Fp, Gs^Fp, Gs^Fp, Gs^Fp, Gs^Fp, Gs^Fp, Gg, Gg, Gg, Gg, Gg, Gg, Gg, Gg, Gg, Gg
Gg, Rr, Gg, Gg, Ww, Ww, Ww, Ww, Ww, Ww, Gg, Gg, Gg, Gg, Aa, Aa, Gg, Rr, Gs^Fp, Gg^Ve, Gg, Gg, Gg, Gg, Gg, Gg, Gs^Fp, Gs^Fp, Gs^Fp, Gs^Fp, Gs^Fp, Gg, Gg, Gg, Gg, Gg, Gg, Gg, Gg, Gg, Gg, Hh
Gg, Rr, Gg, Gg, Ai, Ww, Ww, Ww, Ww, Gg^Vh, Gg, Gg, Gg, Gg, Aa, Gg, Rr, Rr, Gg, Gg, Gg, Gg, Gg, Gg, Gg, Gg, Gg, Gg, Gg, Gg, Gg, Gg, Gg, Aa, Aa, Gg, Gg^Vh, Gg, Gg, Gs^Fp, Gs^Fp, Hh
Gg, Rr, Gg, Gg, Ai, Ww, Ww, Gg, Gg, Gg, Gg, Gg, Gg, Gg, Aa, Gg, Rr, Gg, Gs^Fp, Gs^Fp, Gg, Gg, Gg, Gg, Gg, Gg, Gg, Gg, Gg, Gg, Gg, Gg, Aa, Aa, Gg, Ww, Ww, Ww, Ww, Gs^Fp, Gs^Fp, Hh
Rr, Rr, Gg^Vh, Gg, Ai, Aa, Aa, Gg, Gg, Gg, Gg, Gg, Gg, Gg, Rr, Rr, Gg, Gs^Fp, Gg, Gg, Gg, Gg, Gg, Gg, Gg^Vh, Gg, Gg, Gg, Gg, Aa, Aa, Gg, Gg, Gg, Hh, Ww, Ww, Ww, Ww, Gs^Fp, Gs^Fp, Gs^Fp
Gg, Gg, Gg, Gg, Aa, Aa, Aa, Gg, Gg, Gg, Gg, Gg, Gg, Gg, Rr, Gg, Gg, Gg, Gg, Gg, Gs^Fp, Gg, Gg, Gg, Gg, Gg, Gg, Gg, Gg, Aa, Aa, Gg, Gg, Gg, Ww, Ww, Ww, Ww, Ww, Gg^Vh, Gg, Gg
Gg, Gg, Gg, Gg, Aa, Aa, Aa, Gg, Gg, Gg, Gg, Gg, Gg, Gg, Rr, Gs^Fp, Gs^Fp, Gg, Gs^Fp, Gs^Fp, Gs^Fp, Gs^Fp, Ss, Ds, Ds, Gg, Gg, Gg, Gg, Aa, Aa, Gg, Gg, Gg, Gs^Fp, Hh, Ww, Ww, Ww, Gg, Gg, Gg
Aa, Aa, Aa, Aa, Gg, Aa, Aa, Gg, Gg, Gg, Gg, Gg, Rr, Rr, Gs^Fp, Gs^Fp, Gs^Fp, Gg, Gs^Fp, Gs^Fp, Gg^Ve, Gg, Ss, Ds, Ds, Ds, Gg, Gg, Gg, Gg, Gg, Gg, Gg, Gg, Gs^Fp, Gs^Fp, Gg^Vh, Ww, Ww, Gg, Hh, Hh
Rr, Gg, Gg, Gg, Aa, Aa, Aa, Aa, Aa, Aa, Rr, Rr, Gg, Gs^Fp, Gg^Ve, Gs^Fp, Hh, Hh, Gg, Gs^Fp, Gs^Fp, Gg, Gg, Ss, Gs^Fp, Ds, Gg, Gg, Aa, Gg, Gg, Gg, Gg, Gg, Gs^Fp, Gs^Fp, Gs^Fp, Gs^Fp, Gs^Fp, Gs^Fp, Gs^Fp, Hh
Gs^Fp, Ds, Gs^Fp, Gs^Fp, Gg, Gg, Gg, Aa, Aa, Aa, Gg, Gg, Gs^Fp, Gs^Fp, Gs^Fp, Gs^Fp, Hh, Hh, Hh, Gs^Fp, Gs^Fp, Gg, Gs^Fp, Gs^Fp, Gg^Ve, Gg, Gg, Gg, Aa, Gg, Gg, Gg, Gg, Gg, Gg, Gs^Fp, Gs^Fp, Gs^Fp, Gs^Fp, Gg, Gg, Gs^Fp
Ss, Gs^Fp, Gg^Ve, Gs^Fp, Gg, Gg, Gg, Gg, Rr, Aa, Gg, Gg, Gg^Ve, Gs^Fp, Gs^Fp, Gs^Fp, Hh, Hh, Hh, Hh, Hh, Hh, Hh, Gs^Fp, Gs^Fp, Gg, Gg, Gg, Aa, Hh, Hh, Hh, Hh, Gg, Gg, Gg, Gs^Fp, Gg, Gg, Gg^Vh, Gg, Gg
Gg, Gg, Gs^Fp, Gs^Fp, Gs^Fp, Gg, Gg, Rr, Gg, Aa, Gg, Gg, Gs^Fp, Gs^Fp, Gs^Fp, Gs^Fp, Gs^Fp, Hh, Hh, Hh, Hh, Mm, Mm, Hh, Gg, Gg, Gg, Gg, Ha, Hh, Hh, Hh, Hh, Gg, Gg, Gg, Gg, Gg, Ds, Gg, Gg, Gg
Gg, Gs^Fp, Gg, Gs^Fp, Gs^Fp, Gg, Rr, Rr, Gg, Gg, Gg, Gg, Gs^Fp, Gs^Fp, Gs^Fp, Gs^Fp, Gg, Gg, Gg, Hh, Hh, Mm, Mm, Hh, Hh, Hh, Hh, Hh, Hh, Mm, Mm, Mm, Hh, Hh, Gg^Vh, Gg, Gg, Gg, Gg, Gg, Gg, Aa
Gs^Fp, Gs^Fp, Gs^Fp, Gs^Fp, Gs^Fp, Rr, Gg, Gg, Gg, Gg, Gg, Gg, Gs^Fp, Gs^Fp, Gg^Ve, Gs^Fp, Gg, Gg, Aa, Aa, Aa, Ha, Hh, Hh, Hh, Hh, Hh, Hh, Ha, Mm, Mm, Mm, Mm, Gg, Gg, Gg, Gg, Gs^Fp, Gg, Gg, Gg, Ha
Gg, Gg, Gs^Fp, Ch, Ch, Ch, Gs^Fp, Gg, Gg, Gg, Gg, Gg, Gs^Fp, Gs^Fp, Gs^Fp, Gs^Fp, Gg, Gg, Gg, Aa, Aa, Aa, Gg, Hh, Hh, Hh, Hh, Mm, Mm, Mm, Mm, Mm, Mm, Hh, Gg, Gg, Gg, Gg, Gg, Gg, Gg, Ha
Gg, Gg, Gg, Ch, 1 Kh, Ch, Gs^Fp, Gs^Fp, Gs^Fp, Gs^Fp, Gg, Gs^Fp, Gs^Fp, Gs^Fp, Gs^Fp, Gg, Gg, Gg, Gg, Aa, Gg, Gg, Gg, Hh, Hh, Hh, Mm, Mm, Mm, Hh, Hh, Ha, Ha, Hh, Hh, Gg, Gg, Gg, Gg, Gg, Hh, Mm
Gg, Gg, Ch, Ch, Ch, Gs^Fp, Gg, Gg, Gs^Fp, Gg^Ve, Gs^Fp, Gs^Fp, Gs^Fp, Gg, Gg, Gg, Gg, Gg, Gg, Gg, Gg, Gg, Gg^Vh, Ww, Hh, Hh, Hh, Mm, Hh, Hh, Hh, Ha, Ha, Gg, Gg, Gg, Gg, Gg, Hh, Hh, Hh, Mm
Gg, Gg, Gg, Gg, Gs^Fp, Gs^Fp, Gg, Gg, Gg, Gs^Fp, Gs^Fp, Gs^Fp, Gg, Gg, Gg, Gg, Gg, Gg, Gg, Gg, Gg, Gg, Ww, Ww, Ww, Ww, Mm, Hh, Hh, Gg, Hh, Gg, Gg, Aa, Gg, Hh, Gg, Gg^Vh, Ww, Ai, Ww, Ai
Gg, Gg, Gg, Gg, Gs^Fp, Gg^Ve, Gg, Gg, Gg, Gg, Gg, Gs^Fp, Gg, Gg, Gg, Gg, Gg, Gg, Gg, Gg, Gg, Gg, Gs^Fp, Ww, Ww, Ww, Ww, Ww, Gg^Vh, Gg, Gg, Gg, Gg, Aa, Aa, Aa, Aa, Ha, Ha, Ai, Ai, Ai
Gg, Gg, Gg, Gg, Gg, Gs^Fp, Gs^Fp, Gs^Fp, Gg, Gg, Gg, Gg, Gs^Fp, Gg, Gg, Gg, Gs^Fp, Gs^Fp, Gs^Fp, Gs^Fp, Gg, Gs^Fp, Gs^Fp, Ww, Ww, Ww, Ww, Ww, Ww, Gs^Fp, Gg, Gg, Gg, Aa, Aa, Gg, Gg, Gg, Hh, Ww, Ww, Ww
Aa, Aa, Gg, Gg, Gg, Gg, Gs^Fp, Gs^Fp, Gs^Fp, Gs^Fp, Gg, Gg, Gs^Fp, Gs^Fp, Gs^Fp, Gs^Fp, Gg, Gs^Fp, Gs^Fp, Gs^Fp, Gs^Fp, Gs^Fp, Gs^Fp, Ww, Ww, Ww, Ww, Ww, Gg, Gg, Gg, Gg, Gg, Aa, Gg, Gg, Gg, Gg, Gg, Hh, Ww, Hh
