Gg, Gg, Gg, Gg, Aa, Aa, Aa, Aa, Gg, Rr, Gg, Gg, Gg, Gg, Gg, Aa, Aa, Aa, Rr, Ds, Ww, Wo, Wo, Ww, Aa, Aa, Ds, Ds, Ww, Ds, Gs^Fp, Gg, Gs^Fp, Gs^Fp, Gs^Fp, Hh, Gs^Fp, Gg, Gg, Aa, Aa, Aa
Gg, Gg, Gg, Gg, Aa, Aa, Aa, Aa, Gg, Rr, Gg, Gg, Gg, Gg, Gg, Aa, Aa, Aa, Aa, Ds, Ww, Wo, Wo, Ww, Ds, Ds, Aa, Ds, Ds, Ds, Gs^Fp, Gs^Fp, Gs^Fp, Gs^Fp, Hh, Hh, Hh, Gg, Gg, Aa, Aa, Aa
Gg, Gg, Gg, Gg, Gg, Aa, Aa, Aa, Aa, Aa, Rr, Gg, Gg, Gg, Gg, Aa, Aa, Aa, Aa, Aa, Ww, Wo, Wo, Ww, Ds, Ds, Aa, Ds, Ds, Ds, Gs^Fp, Gg, Gs^Fp, Hh, Hh, Hh, Gs^Fp, Gg, Gg, Aa, Aa, Aa
Gs^Fp, Gg, Gg, Gg, Gg, Aa, Aa, Aa, Aa, Aa, Rr, Gg, Gg, Gg, Gg, Gg, Rr, Aa, Aa, Aa, Ww, Wo, Wo, Ww, Ds, Ds, Aa, Ds, Ds, Gg, Gg, Gg, Gg, Hh, Ch, Ch, Ch, Gg, Gg, Aa, Aa, Aa
Gg, Gg, Gg, Gg, Gg, Gg, Aa, Aa, Aa, Aa, Aa, Aa, Gg, Gg, Rr, Rr, Gg, Gg, Aa, Ds, Wo, Ww, Ww, Ds, Ds, Gg, Ds, Gg, Gg, Gg, Gg, Gg, Gg, Hh, Ch, 2 Kh, Ch, Gg, Aa, Aa, Aa, Hh
Gg, Gg, Gg, Gg, Gg^Vh, Gg, Aa^Vha, Aa, Aa, Aa, Aa, Aa, Aa, Gg^Vh, Rr, Aa, Gg, Aa, Gg, Ds, Ww, Ds, Ds, Gg, Gg, Gg, Gg, Gg, Aa, Aa, Gg, Gg, Gg, Ch, Ch, Ch, Hh, Aa, Ha, Ha, Ha, Ha
Gg, Gg, Rr, Rr, Rr, Rr, Aa, Aa, Aa, Aa, Aa, Gg, Rr, Rr, Aa, Aa, Aa, Gg, Ds, Ww, Ww, Gg^Vh, Gs^Fp, Gs^Fp, Gg, Gg, Gg, Aa, Aa, Aa, Aa, Gg, Gg, Rr, Gg, Gg, Hh, Ha, Ha, Ha, Ai, Ww
Gg, Rr, Aa, Aa, Aa, Aa, Aa, Aa, Aa, Aa, Aa, Gg, Rr, Gg, Gg, Gg, Gg, Gg, Ds, Ww, Ds, Gg, Gs^Fp, Gs^Fp, Gs^Fp, Gs^Fp, Gs^Fp, Gg, Aa, Aa, Aa, Gg, Gg^Vh, Rr, Gg, Gg, Gg, Ha, Ha, Mm, Ai, Ww
Rr, Rr, Gg, Gg, Aa, Aa, Aa, Aa, Aa, Aa, Rr, Rr, Gg, Gg, Gg, Gg, Gg, Ds, Ds, Ds, Gg, Gg, Gs^Fp, Gg, Gg, Gg, Gs^Fp, Gg, Aa, Aa, Aa, Gg, Rr, Rr, Gg, Gg, Gg, Ha, Ha, Mm, Mm, Ai
Gg, Gg, Gg, Gg, Aa, Aa, Gg, Gg, Gg, Gg, Rr, Aa, Gg, Gg, Gg, Gg, Gg, Ds, Ww, Ww, Gg^Vh, Gs^Fp, Gg, Gg, Gg, Gg, Gs^Fp, Gg, Aa, Aa, Aa, Rr, Gg, Gg, Gg, Gg, Hh, Ha, Ha, Mm, Mm, Ai
Gg, Gg, Gg, Gg, Gg, Gg, Gg, Gg, Rr, Rr, Gg, Aa, Gg, Gg, Gg, Gg, Gg, Ds, Wo, Ww, Ds, Gs^Fp, Gg, Gg, Gg, Gg, Gs^Fp, Gg, Aa, Aa, Aa, Rr, Gg, Gg, Gg, Hh, Hh, Hh, Mm, Ha, Ha, Ai
Hh, Ww, Gg^Vh, Ww, Gg, Gg, Gg, Gg, Rr, Gg, Gg, Gg, Gg, Gg, Gg, Gg, Gg, Ds, Ww, Ww, Ds, Gs^Fp, Ss, Gg, Gg, Gg, Gg^Ve, Gg, Aa, Ha, Rr, Gg, Gg^Vh, Gs^Fp, Hh, Hh, Hh, Hh, Mm, Ha, Ha, Ha
Ww, Ww, Ww, Ww, Gg, Gg, Rr, Rr, Gg, Gg, Gg, Gg, Gg, Gg, Gg, Gg, Gg, Gg, Ds, Ds, Ds, Gs^Fp, Gg, Gg, Gs^Fp, Gs^Fp, Rr, Rr, Aa, Aa, Hh, Hh, Hh, Hh, Hh, Hh, Hh, Hh, Hh, Ha, Ha, Aa
Rr, Ww, Ww, Ww, Gg, Gg, Rr, Gs^Fp, Gs^Fp, Gg, Gs^Fp, Gs^Fp, Gs^Fp, Gs^Fp, Gs^Fp, Gs^Fp, Gs^Fp, Gg, Gs^Fp, Gs^Fp, Gs^Fp, Gs^Fp, Rr, Rr, Rr, Rr, Gg, Gg, Aa, Ha, Hh, Hh, Hh, Hh, Hh, Mm, Mm, Hh, Hh, Ha, Aa, Gg
Ww, Ww, Ww, Ww, Ww, Gg, Rr, Gs^Fp, Gg^Ve, Gs^Fp, Gs^Fp, Gs^Fp, Gs^Fp, Gg, Gs^Fp, Gs^Fp, Gs^Fp, Gs^Fp, Gs^Fp, Gs^Fp, Rr, Rr, Gs^Fp, Gs^Fp, Gs^Fp, Hh, Gg^Vh, Hh, Ha, Ha, Hh, Hh, Hh, Hh, Hh, Mm, Mm, Hh, Hh, Hh, Aa, Gg
Ww, Ww, Ww, Ww, Ww, Ww, Rr, Gs^Fp, Gs^Fp, Gs^Fp, Gs^Fp, Gg, Gg, Gs^Fp, Gg^Ve, Gs^Fp, Gs^Fp, Gs^Fp, Gs^Fp, Rr, Gs^Fp, Gg^Ve, Gs^Fp, Gg, Hh, Hh, Hh, Hh, Ha, Mm, Hh, Hh, Hh, Hh, Hh, Mm, Hh, Hh, Hh, Hh, Gg, Gg
Ww, Hh, Hh, Ww, Gg^Ve, Gs^Fp, Gs^Fp, Rr, Gs^Fp, Gs^Fp, Gg, Gg, Gs^Fp, Gs^Fp, Gs^Fp, Gs^Fp, Gs^Fp, Gs^Fp, Rr, Rr, Gs^Fp, Gs^Fp, Hh, Mm, Mm, Mm, Mm, Mm, Ha, Ha, Hh, Hh, Gg, Gg, Gg, Ha, Hh, Hh, Gg, Gg, Gg, Gg
Gg, Gg, Gg, Ww, Gs^Fp, Gs^Fp, Rr, Rr, Gg, Gs^Fp, Gs^Fp, Gg, Gs^Fp, Gg, Gs^Fp, Hh, Gg, Rr, Gs^Fp, Gs^Fp, Gs^Fp, Gg, Mm, Mm, Mm, Mm, Mm, Mm, Hh, Hh, Hh, Gg, Gg, Gg, Gg, Gg, Gg, Gg^Vh, Gg, Gg, Gg, Gg
Gg, Gg, Gg, Gs^Fp, Gs^Fp, Gs^Fp, Rr, Gs^Fp, Gg, Gg, Gs^Fp, Hh, Gg, Gg, Gg, Gg, Rr, Rr, Gg, Gs^Fp, Gs^Fp, Gg, Hh, Mm, Mm, Mm, Mm, Mm, Hh, Gg, Gg, Gg, Gg, Gg, Gg, Gg, Gg, Gg, Gg, Gg, Gg, Gg
Gg, Gg, Gg, Gg, Gs^Fp, Gs^Fp, Rr, Gg, Hh, Hh, Hh, Hh, Hh, Hh, Rr, Rr, Gg, Gs^Fp, Gs^Fp, Gg, Gs^Fp, Gg, Hh, Mm, Mm, Mm, Mm, Hh, Hh, Gg, Gg, Gg, Gg^Vh, Gg, Gg, Gg, Gg, Gg, Gg, Gg, Gg, Gg
Gg, Gg, Gg, Gg, Gg, Gg, Rr, Hh, Hh, Hh, Mm, Hh, Hh, Gg, Rr, Gg, Gg, Gs^Fp, Gs^Fp, Gg, Gg, Gg, Hh, Hh, Mm, Mm, Mm, Hh, Gg, Gg, Gg, Gg, Gg, Gg, Gg, Gg, Gs^Fp, Gg, Gg^Vh, Gg, Gg, Gg
Gg, Gg, Gg, Gg, Gg, Gg, Rr, Gg, Hh, Mm, Hh, Hh, Rr, Gg^Vh, Rr, Gg, Gg, Gs^Fp, Gs^Fp, Gg, Gg, Gg, Gg, Hh, Hh, Ha, Ha, Hh, Gg, Gs^Fp, Gs^Fp, Gg, Gg, Gg, Gg, Gg, Gg, Gg, Gg, Gg, Gg, Gg
Gg, Ds, Ds, Gg, Gg, Gg, Gg, Rr, Hh, Hh, Hh, Rr, Gg^Vh, Rr, Gg, Gg, Gg, Gs^Fp, Gg^Ve, Hh, Gg, Gg, Gg, Gg, Gg, Aa, Aa, Gg, Gg, Gs^Fp, Gs^Fp, Gs^Fp, Gg, Gg, Gg, Gg, Gg, Gg, Gg, Gg, Gg, Gg
Gs^Fp, Ds, Ds, Gg, Gg, Gg, Gg^Vh, Rr, Gs^Fp, Gs^Fp, Rr, Rr, Gs^Fp, Gg, Gg, Gg, Hh, Gg, Hh, Hh, Gs^Fp, Gs^Fp, Gg, Gg, Gg, Aa, Aa, Gg, Gg, Gg^Ve, Gs^Fp, Gs^Fp, Gg, Gg, Gg, Gg, Gg, Gg, Gg, Gg, Gg, Gg
Gg, Gg, Gg, Gg, Gg, Gg, Gg, Rr, Gg, Gg, Rr, Gg, Gs^Fp, Gg, Hh, Hh, Mm, Mm, Hh, Hh, Hh, Gg, Gg, Gg, Aa, Aa, Aa, Gg, Gg, Gg, Gs^Fp, Gs^Fp, Gg, Gg, Gg, Gg, Gg, Gg, Gg, Gg, Gg, Gg
Gg, Gg, Gg, Gg, Gg, Gg, Gg, Rr, Gg, Gg, Rr, Gg, Gg, Gs^Fp, Hh, Mm, Mm, Mm, Hh, Hh, Hh, Hh, Gg, Gg, Gg, Aa, Gg, Gg, Gg, Gs^Fp, Hh, Gs^Fp, Gs^Fp, Gg, Gg, Gg, Gs^Fp, Gg, Gg, Gg, Gg, Gg
Gg, Gg, Gg, Gg, Gg, Gg, Gg, Rr, Gg^Vh, Gg, Rr, Gg, Gg, Hh, Mm, Mm, Mm, Ha, Hh, Hh, Gg, Gg, Gg, Gg, Gg, Gg, Gg, Gg, Gs^Fp, Gs^Fp, Gg, Gg, Gg^Ve, Gs^Fp, Gg, Gg, Ds, Ds, Ds, Gg, Gg, Gg
Gg, Gg, Gg, Gg, Gg, Gg, Gg, Rr, Rr, Rr, Gg, Gg, Gg, Hh, Mm, Mm, Ha, Ha, Ha, Gg, Gg, Gg, Gg, Gg, Gg, Gg, Gg, Gg, Gs^Fp, Gg, Gg, Gs^Fp, Gs^Fp, Gg, Ds, Ww, Wo, Wo, Ds, Gs^Fp, Gs^Fp, Gg
Gg, Gg, Gg, Gs^Fp, Gs^Fp, Gg, Rr, Aa, Rr, Gg, Gg, Gs^Fp, Gs^Fp, Gg, Gg, Ha, Ha, Ha, Aa, Aa, Gg, Gg, Gg, Gg, Gg, Gg, Gg, Gs^Fp, Gs^Fp, Gs^Fp, Gs^Fp, Gs^Fp, Gg, Ds, Ds, Ww, Wo, Ww, Ds, Gs^Fp, Gs^Fp, Gg
Gg, Gg, Gs^Fp, Ch, Ch, Ch, Gg, Aa, Aa, Gg, Gg, Gs^Fp, Gs^Fp, Gg, Gg^Vh, Aa, Aa, Aa, Aa, Gg, Gg, Gg, Gg, Gs^Fp, Gg, Gg, Gs^Fp, Gs^Fp, Gs^Fp, Gg, Gg, Gg, Gg, Gg, Gg, Gg, Gg, Gg^Vh, Gg, Gg, Gg, Gg
Gg, Gg, Gs^Fp, Ch, 1 Kh, Ch, Gg, Aa, Rr, Gg, Gs^Fp, Gs^Fp, Gs^Fp, Gg, Gg, Aa, Aa, Gg, Gg, Gg, Gg, Gg, Gs^Fp, Gs^Fp, Gg, Gs^Fp, Gg^Ve, Gs^Fp, Gg, Hh, Gg, Gg, Gg, Gg, Aa, Aa, Aa, Aa, Gg, Gg, Gg, Gg
Gg, Gg, Ch, Ch, Ch, Gg, Gg, Gg, Rr, Gg, Gg, Gg, Gg, Gg, Aa, Aa, Aa, Gg, Gg, Gs^Fp, Gs^Fp, Gs^Fp, Gs^Fp, Gs^Fp, Gs^Fp, Gs^Fp, Gs^Fp, Gs^Fp, Hh, Hh, Hh, Gg, Gg, Gg, Aa, Aa, Aa, Aa, Gg, Gg, Gg, Gg
Gg, Gg, Gg, Gg, Gg, Gg, Gg, Gg, Gg, Rr, Rr, Gg, Gg, Aa, Aa, Aa, Aa, Gg, Gg, Gs^Fp, Gg^Ve, Gs^Fp, Gs^Fp, Gs^Fp, Gs^Fp, Gs^Fp, Hh, Hh, Hh, Mm, Hh, Gg^Vh, Gg, Gg, Aa, Aa, Gg, Gg, Gg, Gg, Gg, Gg
Gg, Gg, Gg, Gg, Gg, Gg, Gg, Gg, Gg, Gg, Gg, Rr, Aa, Aa, Aa, Aa, Aa, Gg, Gg, Gs^Fp, Gs^Fp, Gs^Fp, Gg, Gs^Fp, Gg, Gg, Hh, Hh, Hh, Hh, Hh, Gg, Gg, Gg, Gg, Gg, Gg, Gg, Gg, Gg, Gg, Gg
Gg, Hh, Hh, Gg, Gg, Gg, Gg, Gs^Fp, Gs^Fp, Gg, Gg, Rr, Rr, Aa, Aa, Aa, Aa, Gg, Gg, Gs^Fp, Gs^Fp, Gs^Fp, Gs^Fp, Gs^Fp, Gg, Gg, Hh, Mm, Mm, Hh, Hh, Gg, Gg, Gg, Gg, Gg, Hh, Hh, Gg, Gg^Vh, Gg, Gg
Hh, Hh, Hh, Gg, Gg, Gs^Fp, Gs^Fp, Gs^Fp, Gg^Ve, Gs^Fp, Gs^Fp, Gs^Fp, Rr, Gg, Gg, Aa, Gg, Gg, Gg, Gg, Hh, Hh, Gs^Fp, Gs^Fp, Gs^Fp, Gg^Vh, Hh, Hh, Hh, Hh, Gg, Gg, Gg, Gg, Aa, Gg, Hh, Mm, Hh, Gg, Gg, Gg
Mm, Ha, Gg, Gg, Gg, Gg, Gs^Fp, Gs^Fp, Gs^Fp, Gs^Fp, Gs^Fp, Gs^Fp, Gs^Fp, Rr, Rr, Gg, Gg^Vh, Gg, Gg, Hh, Mm, Hh, Hh, Gs^Fp, Gs^Fp, Hh, Hh, Ha, Ha, Hh, Gg, Gg, Gg, Aa, Aa, Ha, Hh, Hh, Mm, Gg, Gg, Gg
Mm, Ha, Aa, Gg, Gg, Gg, Gg, Gs^Fp, Gg, Gs^Fp, Gs^Fp, Gs^Fp, Gs^Fp, Gs^Fp, Gs^Fp, Rr, Rr, Gg, Gg, Hh, Hh, Gs^Fp, Gg, Gg, Gg, Gg, Gg, Aa, Ha, Ha, Aa, Gg, Gg, Gg, Aa, Ha, Hh, Hh, Hh, Gg, Gg, Gg
Ha, Aa, Aa, Aa, Aa, Gg, Gg^Vh, Gg, Gg, Gg, Gs^Fp, Gs^Fp, Gs^Fp, Gs^Fp, Ds, Ds, Gs^Fp, Rr, Rr, Gg, Gg, Gs^Fp, Gg, Gg, Gg, Gg, Gs^Fp, Gg, Gg, Aa, Aa, Aa, Gg, Gg, Gg, Hh, Mm, Hh, Hh, Gg, Gg, Aa
Aa, Aa, Aa, Aa, Aa, Gg, Gg^Vh, Gg, Gg, Gg, Gg, Gg, Gs^Fp, Ds, Gs^Fp, Gs^Fp, Gs^Fp, Gg, Rr, Gg, Gg^Vh, Gs^Fp, Rr, Gg, Gg, Gg, Gs^Fp, Gg, Gg, Aa, Aa, Aa, Gg, Gg^Vh, Gg, Gg, Hh, Hh, Gg, Gg, Gg, Gg
Aa, Aa, Aa, Aa, Aa, Gg, Gg, Gg, Gg, Gg, Gg, Gg, Gs^Fp, Gs^Fp, Gs^Fp, Ss, Ss, Gs^Fp, Gg, Rr, Rr, Rr, Gg, Rr, Rr, Gg, Rr, Gs^Fp, Gg, Aa, Aa, Aa, Gg, Gg, Gg, Gg, Gg, Gg, Gg, Gg, Gg, Gg
Ha, Aa, Aa, Aa, Aa, Aa, Gg, Gg, Gg, Gg, Gg, Gg, Gs^Fp, Gs^Fp, Gs^Fp, Gs^Fp, Gs^Fp, Gg, Gg, Aa, Gg, Gg, Gs^Fp, Gs^Fp, Gs^Fp, Rr, Gs^Fp, Rr, Rr, Aa, Aa, Gg, Gg, Gg, Gg, Gs^Fp, Gs^Fp, Gg, Gg, Gg, Gg, Gg
