Gg, Gg, Gg, Gg, Gs^Fp, Gs^Fp, Gg, Gg, Gg, Gg, Gg, Gg, Ha, Mm, Mm, Mm, Mm, Mm, Hh, Gg, Gg, Gg, Gg, Aa, Aa, Aa, Aa, Aa, Gg, Gg, Rr, Gg, Rr, Gg, Rr, Rr, Gg, Rr, Gg, Gg, Gg, Gg
Gg, Aa, Gg, Gg, Gg, Gg, Gg, Gg, Gg, Gg, Gg, Gg, Hh, Mm, Mm, Mm, Mm, Mm, Hh, Hh, Hh, Gg, Aa, Aa, Aa, Gg, Gg, Gg, Rr, Rr, Gg, Rr, Gg, Rr, Gg, Gg, Gg, Gg, Gg, Gg, Gg, Aa
Gg, Gg, Gg^Vh, Gg, Gg, Gg, Gg, Gg, Gg, Gg, Gg, Gg, Hh, Mm, Mm, Mm, Mm, Mm, Mm, Hh, Hh, Aa, Aa, Aa, Aa, Gg, Rr, Rr, Ds, Gg, Gs^Fp, Gs^Fp, Gs^Fp, Gg, Gg, Gg, Gs^Fp, Gg, Gg, Gg, Gg, Gg
Gg, Gg, Gg, Gg, Ch, Ch, Ch, Gg, Gg, Gg, Gg, Gg, Gg, Hh, Mm, Mm, Hh, Mm, Hh, Hh, Hh, Aa, Aa, Aa, Aa, Rr, Gg, Gg, Gg, Ds, Gs^Fp, Gs^Fp, Gs^Fp, Gg, Gg, Gs^Fp, Gs^Fp, Gg, Gg, Gg, Gg, Gg
Gg, Gs^Fp, Gg, Gg, Ch, 1 Kh, Ch, Gg, Gg, Gg, Gs^Fp, Gs^Fp, Gs^Fp, Gg, Hh, Hh, Hh, Mm, Mm, Hh, Hh, Aa, Aa, Aa, Aa, Rr, Gg, Gg, Gg, Gg, Gs^Fp, Gs^Fp, Gs^Fp, Gs^Fp, Gs^Fp, Gs^Fp, Gs^Fp, Gg, Gg, Gg, Gg, Gg
Gs^Fp, Gs^Fp, Gs^Fp, Ch, Ch, Ch, Gg, Gg, Gg, Gs^Fp, Gg^Ve, Gs^Fp, Gs^Fp, Gs^Fp, Gg, Hh, Gg^Vh, Hh, Ha, Ha, Ha, Ha, Aa, Aa, Aa, Rr, Gg, Gg, Gg, Gs^Fp, Gs^Fp, Gs^Fp, Ss, Ss, Ss, Gs^Fp, Gs^Fp, Gg, Gg, Gg, Gg, Aa
Gg, Gs^Fp, Gg, Gg, Rr, Gg, Gg, Gg, Gs^Fp, Gs^Fp, Gs^Fp, Gs^Fp, Gs^Fp, Gg, Gg, Gg, Gg, Gg, Ha, Ha, Ha, Aa, Aa, Aa, Aa, Rr, Gg, Gg, Gs^Fp, Ss, Gg, Gg, Gg, Ss, Ss, Ss, Gs^Fp, Gg^Vh, Gg, Gg, Aa, Aa
Gg, Gg, Gg, Gg, Gg^Vh, Rr, Rr, Gg, Hh, Gs^Fp, Gs^Fp, Gs^Fp, Gg, Gg, Gg, Gg, Gg, Gg, Gg, Ha, Aa, Gg, Rr, Rr, Rr, Rr, Gg, Gg, Gs^Fp, Gg, Gg, Gg, Gg, Ss, Gs^Fp, Ds, Ds, Gg, Gg, Gg, Aa, Aa
Aa, Aa, Aa, Gg, Gg, Gg, Aa, Rr, Rr, Gg, Gg, Gg, Gg, Gg, Aa, Gg, Gg, Gg, Gg, Gg, Hh, Rr, Gg^Vh, Gg, Gg, Gg, Gg, Gs^Fp, Gg^Ve, Gg, Gg, Gg, Gg, Ss, Gg^Ve, Ww, Ds, Ds, Gg, Gg, Aa, Aa
Aa, Aa, Aa, Gg, Gg, Gg, Gg, Gg, Rr, Gg^Vh, Gg, Gg, Aa, Aa, Aa, Gg, Gg, Gs^Fp, Rr, Rr, Rr, Rr, Gg, Gs^Fp, Gs^Fp, Gg, Gg, Gs^Fp, Gs^Fp, Gg, Gg, Gg, Gg, Gs^Fp, Gs^Fp, Ds, Gg, Gg, Gg, Gg, Gg, Gg
Aa, Aa, Aa, Gg, Gg, Gg, Gg, Gg, Gg, Rr, Rr, Gg, Gg, Aa, Aa, Gg, Gs^Fp, Rr, Gs^Fp, Gs^Fp, Gs^Fp, Gs^Fp, Gs^Fp, Gs^Fp, Gs^Fp, Gg, Gg, Gg, Gs^Fp, Gs^Fp, Gg, Gg, Gs^Fp, Gs^Fp, Gg, Gg, Gg, Gg, Gg, Gg, Gg, Gg
Aa, Aa, Aa, Rr, Gg, Gg, Gg, Gg, Gg, Gg, Gg, Rr, Gg^Vh, Aa, Aa, Gg, Gs^Fp, Rr, Gs^Fp, Gs^Fp, Gg^Ve, Gs^Fp, Gs^Fp, Gs^Fp, Gs^Fp, Gg, Gg, Gg, Gg, Gs^Fp, Gs^Fp, Gs^Fp, Gg, Gg, Gg, Gg, Gg, Gg, Gg, Gg, Gg, Gg
Gg, Aa, Aa, Rr, Gg, Gg, Gg, Gg, Aa, Aa, Gg, Rr, Rr, Aa, Aa, Gg, Rr, Rr, Gs^Fp, Gs^Fp, Gs^Fp, Gs^Fp, Gs^Fp, Gs^Fp, Gs^Fp, Gg, Gg, Gg, Gg, Gg, Gg, Gg, Gg, Gg, Gg, Gg, Gg, Gg, Gg, Gg, Gg, Gg
Gg, Gg, Gg, Rr, Rr, Rr, Rr, Gg, Gg, Gg, Gg, Gg, Gg, Rr, Aa, Aa, Rr, Rr, Rr, Gg, Gg, Gg, Rr, Gs^Fp, Gg, Gg, Gg, Gg, Gg, Gg, Gg, Gg, Gg^Vh, Gg, Gg, Gg, Gg^Vh, Gg, Gg, Gg, Gs^Fp, Gs^Fp
Gg, Gg, Gg, Gg^Vh, Gg, Aa, Aa, Rr, Rr, Gg, Gg, Gg, Rr, Rr, Aa, Aa, Aa, Aa, Gg, Rr, Rr, Rr, Gg, Rr, Gg, Gg, Gg, Gg, Gg, Gg, Aa, Gg, Gg, Gg, Gg, Gg, Gg, Gg, Gg, Gg, Gs^Fp, Hh
Gg, Gg, Gg, Gg, Gg, Aa, Aa, Gg, Gg, Rr, Aa, Aa, Ha, Aa, Aa, Aa, Aa, Aa, Aa, Gg, Gg, Aa, Aa, Rr, Rr, Gg, Gg^Vh, Gg, Gg, Aa, Aa, Aa, Gg, Gg, Gg, Gg, Gg, Gg, Gg, Gg, Hh, Mm
Gg, Gg, Gg, Gg, Gg, Aa, Aa, Gg, Gg, Rr, Aa, Aa, Ha, Ha, Aa, Aa, Aa, Aa, Gg, Hh, Ha, Aa, Aa, Gg, Gg, Rr, Rr, Gg, Gg, Gg, Aa, Gg, Gg, Gg, Gg, Gg, Aa, Aa, Gg, Gg, Hh, Mm
Gg, Gg, Gg, Gg, Gg, Gg, Aa, Aa, Aa, Aa, Aa, Aa, Rr, Ha, Gg^Vh, Gg, Gg, Gg, Gg, Gg, Gg, Aa, Gg, Gg, Gg, Gg, Gg, Rr, Rr, Gg, Gg, Gg, Gg, Gg, Gg, Aa, Aa, Aa, Aa, Hh, Mm, Mm
Gg, Gg, Gg, Gg, Gg, Gg, Aa, Aa, Gg, Gg, Gg, Rr, Gg, Rr, Hh, Hh, Hh, Gg, Gg, Gg, Gg, Gg, Gg, Gg, Gg, Gg, Gg, Aa, Aa, Rr, Gg, Gg, Gg, Gg, Gg, Gg, Aa, Aa, Ha, Mm, Mm, Mm
Gg, Gg, Gg, Gg, Gg, Aa, Aa, Aa, Gg, Gg^Vh, Rr, Rr, Gg, Rr, Hh, Hh, Gs^Fp, Gs^Fp, Gs^Fp, Gg, Gg, Gg, Gg, Gg, Gg, Gg, Aa, Aa, Aa, Aa, Rr, Gg, Gs^Fp, Gg, Gg, Gg, Aa, Ha, Mm, Mm, Mm, Mm
Gg, Hh, Hh, Hh, Hh, Hh, Aa, Gg, Rr, Rr, Gs^Fp, Gg, Rr, Rr, Gg, Gs^Fp, Gs^Fp, Gs^Fp, Gg^Ve, Gs^Fp, Gg, Gg, Gg, Gg, Aa, Aa, Aa, Aa, Aa, Aa, Rr, Gg, Gs^Fp, Gs^Fp, Gg, Gg, Ha, Ha, Mm, Mm, Mm, Mm
Hh, Hh, Hh, Ha, Ha, Hh, Hh, Gg, Rr, Gs^Fp, Gg, Gg, Rr, Gg, Gg, Gg, Gs^Fp, Gs^Fp, Gs^Fp, Gs^Fp, Gg, Gg, Gg, Gg, Aa, Aa, Aa, Aa, Aa, Aa, Rr, Gg, Gs^Fp, Gg^Ve, Gs^Fp, Hh, Hh, Mm, Mm, Mm, Mm^Vhh, Rr
Ha, Hh, Ha, Ha, Ha, Ha, Hh, Gg, Gs^Fp, Rr, Gg, Gg, Rr, Gg, Gg, Gg, Gs^Fp, Gs^Fp, Gs^Fp, Gg, Gg, Gg, Gg, Gg, Gg, Gg, Aa, Aa, Aa, Aa, Rr, Gg, Gs^Fp, Gs^Fp, Gs^Fp, Hh, Mm, Mm, Mm, Mm, Mm, Rr
Ha, Ha, Ha, Mm, Ha, Ha, Gg^Vh, Gg, Gg, Rr, Gg, Gg, Gg, Rr, Gg, Gg, Gg, Gg, Gg, Gs^Fp, Gs^Fp, Gs^Fp, Gs^Fp, Gs^Fp, Gs^Fp, Gg, Gg, Aa, Aa, Aa, Rr, Gg, Gs^Fp, Gg, Hh, Mm, Mm, Mm, Mm, Mm, Mm, Mm
Ha, Ha, Ha, Ha, Ha, Ha, Aa, Aa, Gg, Rr, Gg, Gg, Gg, Aa, Gg, Gg, Gg, Gg, Gg, Gs^Fp, Gs^Fp, Gs^Fp, Gs^Fp, Gg, Gs^Fp, Gg, Gg, Aa, Aa, Gg^Vh, Rr, Gg, Gg, Gg, Hh, Mm, Mm, Mm, Mm, Mm, Mm, Mm
Ha, Ha, Ha, Aa, Ha, Aa, Aa, Gg, Gg^Vh, Rr, Gg, Gg, Gg, Rr, Gg^Vh, Gg, Gg, Gg, Gs^Fp, Gs^Fp, Gs^Fp, Gs^Fp, Gg, Gs^Fp, Gs^Fp, Gs^Fp, Gg, Aa, Aa, Gg, Gg, Rr, Rr, Gg, Hh, Mm, Mm, Mm, Mm, Mm, Mm, Hh
Ha, Ha, Aa, Aa, Aa, Gg, Aa, Aa, Rr, Rr, Gg, Gg, Gg, Rr, Gg, Gg, Gg, Gg, Gs^Fp, Gs^Fp, Gs^Fp, Gs^Fp, Gs^Fp, Gs^Fp, Gs^Fp, Gs^Fp, Gg, Aa, Aa, Gg, Gg, Gg, Aa, Rr, Gg, Hh, Mm, Mm, Mm, Ha, Aa, Gg
Gg, Gg, Gg, Gg, Gg, Aa, Aa, Rr, Gg, Gg, Gg, Gg, Gg, Rr, Rr, Gg, Gs^Fp, Gs^Fp, Gg^Ve, Gs^Fp, Gs^Fp, Gs^Fp, Gs^Fp, Gs^Fp, Gs^Fp, Gg, Gg, Aa, Aa, Aa, Aa, Aa, Gg, Rr, Rr, Gg, Gg, Gg, Aa, Gg, Aa, Gg
Gg, Gg, Gg, Gg, Gg, Gg, Rr, Rr, Gg, Gg, Gg, Gg, Gg, Gg, Gg, Rr, Gs^Fp, Gs^Fp, Gs^Fp, Gs^Fp, Gs^Fp, Gs^Fp, Gs^Fp, Gs^Fp, Gg, Gg, Gg, Aa, Aa, Aa, Aa, Gg, Gg, Gg^Vh, Rr, Gg, Gg, Gg, Aa, Aa, Rr, Rr
Gs^Fp, Gs^Fp, Gs^Fp, Gs^Fp, Gg, Gg, Rr, Gs^Fp, Gs^Fp, Gs^Fp, Gs^Fp, Gg, Gg, Gg, Gg, Rr, Rr, Gs^Fp, Gs^Fp, Gs^Fp, Gs^Fp, Gs^Fp, Gg, Gg, Gg, Gg, Gg, Aa, Gg, Aa, Aa, Gg, Gg, Gg, Gg, Rr, Rr, Aa, Aa, Rr, Gg, Gg
Hh, Gs^Fp, Gg^Ve, Gs^Fp, Gg, Gg, Rr, Gs^Fp, Gs^Fp, Ss, Gs^Fp, Gs^Fp, Gg, Aa, Gg, Gg, Rr, Gg^Ve, Gs^Fp, Gs^Fp, Gs^Fp, Gg, Gg, Gg, Gg, Gg^Vh, Aa, Aa, Aa, Gg, Aa, Gg, Gg, Gs^Fp, Gs^Fp, Gs^Fp, Rr, Gg, Aa, Rr, Gg, Gg
Gs^Fp, Gs^Fp, Gs^Fp, Gs^Fp, Gs^Fp, Gg, Rr, Gs^Fp, Ss, Ss, Ss, Gs^Fp, Gg^Vh, Aa, Gg, Gg, Gg, Rr, Gs^Fp, Gs^Fp, Gs^Fp, Gg, Gg, Gg, Gg, Gg, Gg, Aa, Aa, Aa, Aa, Gg, Gg, Gs^Fp, Gs^Fp, Gs^Fp, Rr, Gg, Aa, Rr, Gg, Gg
Gg, Gg, Gs^Fp, Gs^Fp, Gg, Rr, Gs^Fp, Gs^Fp, Ss, Ss, Ss, Gs^Fp, Ww, Aa, Aa, Gg, Gg, Rr, Rr, Gg, Gg, Gg, Gg, Aa, Aa, Gg, Aa, Aa, Aa, Aa, Aa, Gg, Gs^Fp, Gs^Fp, Gs^Fp, Ch, Ch, Ch, Gg, Rr, Gg, Gs^Fp
Hh, Gg, Hh, Gg, Gg, Rr, Gs^Fp, Gs^Fp, Gg, Gg, Gs^Fp, Ww, Ww, Aa, Aa, Gg, Gg, Gg, Gg, Rr, Gg, Gg, Aa, Aa, Aa, Aa, Aa, Aa, Aa, Gg, Gg, Gs^Fp, Gs^Fp, Ss, Gs^Fp, Ch, 2 Kh, Ch, Gg, Rr, Gg, Gs^Fp
Gg, Hh, Hh, Hh, Rr, Rr, Gs^Fp, Gs^Fp, Gs^Fp, Gs^Fp, Gs^Fp, Ww, Ww, Ai, Ww, Ww, Ww, Gs^Fp, Gg^Ve, Rr, Rr, Aa, Aa, Aa, Aa, Aa, Aa, Gg, Gg, Gg, Gs^Fp, Ss, Ss, Gg, Ch, Ch, Ch, Gg, Gg, Rr, Gg, Gg
Gg, Gg, Hh, Rr, Hh, Gg, Gg, Gg, Gg, Gg, Ww, Ww, Ai, Ai, Ww, Ww, Gs^Fp, Ww, Ww, Ww, Rr, Aa, Aa, Aa, Aa, Gg, Gg, Gg, Gg, Gs^Fp, Ss, Gg, Gg, Ss, Gs^Fp, Gg, Aa, Aa, Rr, Rr, Gg, Gg
Gg, Gg, Hh, Rr, Hh, Gg, Hh, Hh, Ha, Mm, Ww, Ww, Ww, Ai, Ww, Hh, Gs^Fp, Gs^Fp, Gs^Fp, Ww, Ww, Aa, Aa, Aa, Gg, Gg, Gg, Gg, Gg, Ss, Gg, Gg, Gg, Ss, Gs^Fp, Gg, Aa, Aa, Rr, Gg^Vh, Gg, Gs^Fp
Gg, Gg, Gg^Ve, Rr, Hh, Hh, Mm, Ha, Ha, Mm, Mm^Vhh, Ww, Mm, Ww, Hh, Hh, Gs^Fp, Gs^Fp, Gs^Fp, Gg, Ww, Rr, Aa, Aa, Gg, Gg, Gg, Gs^Fp, Gs^Fp, Gg, Gg, Gg^Vh, Gg, Ss, Gs^Fp, Gg, Aa, Aa, Rr, Gg, Gg, Gs^Fp
Gg, Gs^Fp, Gs^Fp, Rr, Hh, Mm, Mm, Mm, Mm, Mm, Mm, Mm, Mm, Hh, Gg, Gg, Gs^Fp, Gs^Fp, Gs^Fp, Gg, Ww, Rr, Gg, Gg, Gg, Gg, Gg, Gs^Fp, Gg^Ve, Gg, Gg, Gg, Gg, Ss, Gs^Fp, Gg, Rr, Rr, Gg, Gg, Gg, Gg
Gg, Gg, Gg, Rr, Hh, Hh, Mm, Mm, Mm, Mm, Mm, Mm, Hh, Gg, Gg, Gg, Gg, Gg, Gg, Gg, Ww, Rr, Gg, Gg, Gg, Gg, Gg, Gg, Gs^Fp, Gs^Fp, Rr, Rr, Rr, Rr, Rr, Rr, Gg, Gg, Gg, Gs^Fp, Gs^Fp, Gs^Fp
Gg, Gg, Gg, Rr, Gg, Hh, Hh, Mm, Mm, Mm, Mm, Hh, Gg, Gg, Aa, Aa, Aa, Aa, Gg^Vh, Ww, Rr, Rr, Gs^Fp, Gg, Gg, Gg, Rr, Rr, Rr, Rr, Rr, Gs^Fp, Rr, Gs^Fp, Gs^Fp, Gs^Fp, Gg, Gg, Gg, Gs^Fp, Gs^Fp, Gg
Gg, Gg, Rr, Rr, Gg, Gg, Hh, Mm, Mm, Mm, Mm, Hh, Gg, Gg, Gg, Gg, Aa, Gg, Gg, Ww, Rr, Gs^Fp, Rr, Rr, Rr, Rr, Aa, Gg, Rr, Rr, Gs^Fp, Rr, Gg, Rr, Rr, Gs^Fp, Rr, Rr, Rr, Gg, Rr, Ds
