Gg, Gg, Gs^Fp, Gs^Fp, Gs^Fp, Gs^Fp, Gg, Gg, Gg, Gg, Gg, Gg, Gg, Gg, Aa, Gg, Ds, Gg, Gg, Gg, Gg, Gg, Gs^Fp, Gg, Hh, Hh, Hh, Gs^Fp, Gg, Gg, Gg, Gg, Gg, Gg, Gs^Fp, Gs^Fp, Gs^Fp, Gs^Fp, Gs^Fp, Gg, Gg, Gg
Gg, Gg, Gs^Fp, Gs^Fp, Gs^Fp, Gs^Fp, Gg, Gg, Gg, Aa, Aa, Gg, Gg, Gg, Aa, Gg, Gg, Gg, Gg, Gg, Gg, Gg, Gs^Fp, Hh, Hh, Hh, Gs^Fp, Gg, Gg, Gg, Gg, Gg, Gg, Gg, Gs^Fp, Gs^Fp, Gs^Fp, Gs^Fp, Gs^Fp, Gs^Fp, Gs^Fp, Gs^Fp
Gg, Gg, Gg, Gs^Fp, Gs^Fp, Gg, Gg, Gg, Gg, Aa, Aa, Gg, Gg, Gg, Gg, Gg, Gg, Aa, Aa, Gg, Gg, Gg, Gg, Hh, Mm, Mm, Hh, Gg, Gg, Gg, Gg, Gg, Gg, Gg, Gg, Gg, Gs^Fp, Gs^Fp, Gs^Fp, Gs^Fp, Gs^Fp, Gs^Fp
Gg, Gg, Gg, Gg, Gg, Gg, Gg, Gg, Aa, Aa, Aa, Aa, Gg, Gg, Gg, Gg, Gg, Gg, Gg, Gg, Gg, Gg, Gs^Fp, Hh, Mm, Mm, Mm, Hh, Gg, Gg, Gg, Gg, Gg, Gg, Gg, Ch, Ch, Ch, Gs^Fp, Gg^Ve, Gs^Fp, Hh
Gg, Gg, Hh, Hh, Gg, Gg, Gg, Gg, Aa, Aa, Gg, Aa, Gg, Gg, Gg, Gg, Gg, Gg, Gg, Gg, Gg^Vh, Gs^Fp, Hh, Mm, Mm, Mm, Hh, Gg, Gg, Gg, Gg, Gg, Gg, Gg, Gg, Ch, 2 Kh, Ch, Gg, Gs^Fp, Gs^Fp, Gs^Fp
Gg, Hh, Hh, Hh, Hh, Gg, Gg, Gg, Aa, Aa, Aa, Gg, Gg^Vh, Gg, Gg, Gg, Gg, Gg, Gg, Gg, Gg, Gs^Fp, Hh, Mm, Mm, Mm, Hh, Gg, Gg, Gg, Gg, Gg, Gg, Gg, Ch, Ch, Ch, Gg, Gg, Gg, Gg, Gg
Gs^Fp, Hh, Hh, Gg^Vh, Hh, Gg, Gg, Gg, Gg, Gg, Gg, Gg, Gg, Gg, Gg, Gg, Gg, Gg, Gg, Gg, Gs^Fp, Hh, Hh, Hh, Mm, Hh, Hh, Gg, Gg, Gg, Rr, Gg^Vh, Rr, Rr, Rr, Rr, Gg, Aa, Gg, Gg, Gg, Gg
Gs^Fp, Hh, Hh, Hh, Hh, Hh, Gg, Gg, Gg, Gg, Gg, Gg, Gg, Gg, Gg, Gg, Gg, Gg, Gg, Gg, Hh, Hh, Hh, Hh, Hh, Hh, Hh, Gg^Vh, Rr, Rr, Gg, Rr, Gs^Fp, Gs^Fp, Gs^Fp, Gg, Gg, Gg, Aa, Aa, Gg, Gg
Gs^Fp, Gg, Hh, Hh, Hh, Gs^Fp, Gs^Fp, Gs^Fp, Gg, Gg, Ds, Gg, Ds, Ds, Gg^Vh, Gg, Gg, Gg, Gg, Gg, Gs^Fp, Hh, Hh, Gg, Hh, Hh, Rr, Rr, Gg, Gg, Gs^Fp, Ss, Ds, Gg^Ve, Gs^Fp, Gg, Gg, Aa, Aa, Aa, Aa, Gg
Gs^Fp, Gg, Hh, Hh, Hh, Gs^Fp, Gs^Fp, Gs^Fp, Gs^Fp, Gg, Ds, Ww, Wo, Ww, Ds, Gg, Gg, Gg, Gg, Gg, Gs^Fp, Gg, Gg, Gg, Gs^Fp, Gs^Fp, Rr, Gs^Fp, Gg, Gg, Gs^Fp, Ds, Ds, Ss, Gs^Fp, Gg, Aa, Aa, Aa, Aa, Aa, Ds
Gs^Fp, Gg, Hh, Hh, Hh, Gs^Fp, Gs^Fp, Gs^Fp, Gs^Fp, Gs^Fp, Ds, Ww, Wo, Ww, Gg, Gg, Gg, Gg, Gg, Gg, Gs^Fp, Gg, Gg, Gs^Fp, Gs^Fp, Gs^Fp, Rr, Gs^Fp, Gs^Fp, Gg, Ss, Ss, Ss, Ds, Gg, Gg, Aa, Aa, Gg, Gg, Gg, Gg
Gs^Fp, Gg, Gg, Hh, Hh, Gs^Fp, Gs^Fp, Gs^Fp, Gs^Fp, Gs^Fp, Gs^Fp, Gs^Fp, Ds, Ds, Gg, Gg, Gg, Gg, Gg, Gg, Gs^Fp, Gg, Gg, Gg, Rr, Rr, Gs^Fp, Gs^Fp, Gg^Ve, Gs^Fp, Gs^Fp, Gs^Fp, Gs^Fp, Gs^Fp, Gg, Gg, Aa, Aa, Gg, Gg, Gg, Gg
Gs^Fp, Gg, Gs^Fp, Gg, Gg, Gg, Gs^Fp, Gg, Gs^Fp, Gg^Ve, Gs^Fp, Gs^Fp, Gg, Gg, Gg, Gg, Gg, Gg, Gg, Gg, Gg^Ve, Gs^Fp, Rr, Rr, Gg, Gs^Fp, Gs^Fp, Gs^Fp, Gs^Fp, Gs^Fp, Gs^Fp, Gs^Fp, Gg, Gg, Gg, Gg, Gg, Aa, Gg, Gs^Fp, Gs^Fp, Gs^Fp
Gs^Fp, Gs^Fp, Gg^Ve, Gg, Gg, Gg, Gg, Gg, Gg, Gs^Fp, Gs^Fp, Gs^Fp, Gg, Gg, Gg, Gg, Gg, Gg, Gg, Gs^Fp, Gs^Fp, Rr, Gs^Fp, Gg, Gs^Fp, Gs^Fp, Hh, Hh, Gg, Gg, Gg, Gg, Gg, Gg, Gg, Gg, Gg, Gg, Gs^Fp, Gs^Fp, Gg, Gg
Gg, Gs^Fp, Gs^Fp, Gg, Gg, Gg, Gg, Gg, Gg, Gs^Fp, Gs^Fp, Gs^Fp, Gs^Fp, Gs^Fp, Gs^Fp, Gg, Gg, Gg, Gg, Gg, Gg, Rr, Gs^Fp, Hh, Hh, Hh, Hh, Hh, Hh, Hh, Hh, Hh, Aa, Aa, Gg, Gg, Gg, Gg, Gg^Ve, Gg, Gg, Gg
Gs^Fp, Gg, Hh, Gg, Gg, Aa, Aa, Gg, Gg, Hh, Hh, Gs^Fp, Gg, Gs^Fp, Gs^Fp, Gs^Fp, Gs^Fp, Gg, Gg, Gg, Hh, Rr, Gs^Fp, Hh, Hh, Mm, Mm, Mm, Ww, Mm, Hh, Ha, Hh, Hh, Gg, Gs^Fp, Gs^Fp, Gs^Fp, Gs^Fp, Gg, Gg, Gg
Gs^Fp, Gs^Fp, Hh, Gg, Gg, Gg, Gg, Gg, Hh, Hh, Hh, Hh, Gg, Gg, Gg, Gg^Ve, Gs^Fp, Gg, Gg, Gg, Rr, Rr, Gg, Gg, Hh, Mm, Ww, Ww, Ww, Ai, Ha, Hh, Hh, Hh, Hh, Hh, Gs^Fp, Gg, Gg, Gg, Gs^Fp, Gg
Gs^Fp, Gs^Fp, Gs^Fp, Gg, Gg, Gg, Gs^Fp, Gg, Hh, Hh, Mm, Hh, Gg, Gg, Gg, Gs^Fp, Gs^Fp, Gg, Gg^Vh, Rr, Gg, Gg, Gg, Gg, Hh, Ww, Ww, Ww, Ai, Ai, Aa, Gg^Vh, Hh, Hh, Hh, Hh, Gs^Fp, Gs^Fp, Gs^Fp, Gs^Fp, Gs^Fp, Gs^Fp
Gs^Fp, Gs^Fp, Gs^Fp, Gs^Fp, Gs^Fp, Gs^Fp, Gs^Fp, Gs^Fp, Gs^Fp, Hh, Mm, Hh, Gs^Fp, Gs^Fp, Gs^Fp, Gs^Fp, Gs^Fp, Gg, Rr, Rr, Gg, Gg, Gg, Gg, Ww, Ww, Ww, Ww, Ai, Ai, Ai, Ww, Hh, Hh, Hh, Hh, Gs^Fp, Gg, Gg, Gg, Gg, Gg
Gs^Fp, Gs^Fp, Gs^Fp, Gs^Fp, Gs^Fp, Gs^Fp, Gs^Fp, Hh, Hh, Hh, Mm, Hh, Hh, Hh, Gs^Fp, Gg^Ve, Gs^Fp, Gg, Rr, Gg, Gg, Aa, Aa, Gg, Gg^Vh, Ww, Ww, Ww, Ww, Gg, Gg, Gg, Gg, Gg, Hh, Hh, Gg, Gg, Gg, Gg, Gg, Gg
Gs^Fp, Gs^Fp, Gs^Fp, Gs^Fp, Gg, Gg, Gs^Fp, Gg, Gs^Fp, Hh, Hh, Mm, Mm, Mm, Hh, Gg, Gg, Gg, Rr, Gg, Gg, Aa, Aa, Gg, Gg, Ww, Ww, Gs^Fp, Ww, Gs^Fp, Gs^Fp, Gs^Fp, Gs^Fp, Hh, Hh, Hh, Hh, Gg, Gg, Gg, Gg, Gg
Gg, Gs^Fp, Gs^Fp, Gg, Gg, Gg, Gs^Fp, Gg^Ve, Gs^Fp, Hh, Mm, Mm, Mm, Hh, Mm, Hh, Rr, Rr, Gg, Gg, Gg, Gg, Gg, Ds, Gg, Gg, Gg, Gs^Fp, Ww, Gs^Fp, Gg, Gs^Fp, Hh, Hh, Mm, Hh, Hh, Ha, Gg, Gg, Gg, Gg
Gg, Gs^Fp, Gg, Gg, Gg, Gg, Gs^Fp, Gs^Fp, Gs^Fp, Gs^Fp, Hh, Hh, Hh, Hh, Rr, Rr, Gg, Gg, Gg, Gg, Gg, Gg, Gg, Ds, Gg, Gg, Gg, Gg, Gs^Fp, Gg, Gg, Gg, Gg, Mm, Mm, Mm, Mm, Ha, Gg, Gg, Gg, Gs^Fp
Gg, Gs^Fp, Gs^Fp, Gs^Fp, Ss, Gg, Gg, Gs^Fp, Gs^Fp, Gs^Fp, Gs^Fp, Gs^Fp, Rr, Rr, Gg, Hh, Gg, Gg, Gg, Gg, Gg^Vh, Gg, Gg, Ds, Ds, Gg, Gg, Gs^Fp, Gs^Fp, Gg, Gg, Gg, Hh, Hh, Mm, Mm, Mm, Hh, Gg, Gg, Gg, Gg
Gs^Fp, Gs^Fp, Gg^Ve, Gs^Fp, Gg, Ss, Gg, Gs^Fp, Gs^Fp, Gg^Ve, Gs^Fp, Gg, Rr, Gg, Gg, Gg, Gg, Gg, Gg, Gg, Gg, Gg, Ds, Ds, Ds, Gg, Gg, Gs^Fp, Gg^Ve, Gs^Fp, Gg^Vh, Gg, Gg, Hh, Mm, Mm, Mm, Hh, Gg^Vh, Gg, Gg, Gg
Gs^Fp, Gs^Fp, Gs^Fp, Gs^Fp, Ss, Gg, Gg, Gg, Gs^Fp, Gs^Fp, Rr, Rr, Gg, Gg, Gs^Fp, Gg, Gg, Gg, Gg, Gg, Gg, Gg, Gg, Gg, Gg, Gs^Fp, Gg, Gs^Fp, Gs^Fp, Gs^Fp, Gs^Fp, Gs^Fp, Hh, Hh, Hh, Mm, Hh, Hh, Gg, Gg, Gg, Gg
Gs^Fp, Gg, Gs^Fp, Gs^Fp, Ss, Gg, Ds, Gg, Gg, Gs^Fp, Rr, Gg, Gg, Gg, Gs^Fp, Gs^Fp, Gs^Fp, Gg, Gg, Gg, Gg, Gg, Gg, Gg, Gg, Gg, Gg, Gg, Gg, Gg, Gg, Gg, Gg, Hh, Hh, Mm, Hh, Hh, Gg, Gg, Gg, Gg
Gg, Gg, Gg, Gg, Gs^Fp, Gg, Ds, Gg, Gg, Gs^Fp, Rr, Gg, Gg, Gg, Gs^Fp, Gg^Ve, Gs^Fp, Gg, Gg, Aa, Gg, Gg, Gg, Gg, Gg, Gg, Gg, Gg, Gs^Fp, Gs^Fp, Gg, Gg, Gg, Gg, Hh, Hh, Mm, Hh, Gg, Gg, Gg, Gg
Gg, Gg, Gg, Gg, Gs^Fp, Gg, Gg, Gg, Gg, Gg, Rr, Gg, Gg, Gg, Gs^Fp, Gs^Fp, Gs^Fp, Gg, Gg, Aa, Gg, Gg, Gg, Gs^Fp, Gs^Fp, Gs^Fp, Gs^Fp, Gs^Fp, Gs^Fp, Gs^Fp, Gs^Fp, Gs^Fp, Gs^Fp, Hh, Hh, Mm, Hh, Gg, Gg, Gg, Gg, Gg
Gg, Gg, Gg, Gg, Gg, Gs^Fp, Ss, Gg, Gg, Rr, Gs^Fp, Gg, Gg, Gg, Gs^Fp, Gs^Fp, Gg, Gg, Gg, Aa, Aa, Gg, Gg, Gs^Fp, Gs^Fp, Gs^Fp, Gs^Fp, Gs^Fp, Gg, Gs^Fp, Gs^Fp, Gs^Fp, Gs^Fp, Hh, Hh, Hh, Hh, Gg, Aa, Gg, Gg, Gg
Gg, Aa, Aa, Gg, Gg, Gs^Fp, Ss, Gg, Gg, Rr, Gs^Fp, Gg, Gg, Gg, Gg, Gg, Gg, Gg, Gg, Gg, Gg, Gg, Gg, Gg, Gs^Fp, Gs^Fp, Gs^Fp, Gg, Gg, Gg, Gg, Gs^Fp, Gs^Fp, Hh, Hh, Hh, Gg, Gg, Aa, Gg, Gg, Gg
Gg, Gg, Gg, Gg, Gg, Gs^Fp, Gs^Fp, Gs^Fp, Gg, Rr, Gg^Ve, Gs^Fp, Gg, Gg, Gg, Gg, Gg, Gg, Gg, Gg, Gg, Gg, Gg, Gs^Fp, Gs^Fp, Gs^Fp, Gs^Fp, Gs^Fp, Gg, Gs^Fp, Gg, Gs^Fp, Gg^Ve, Gs^Fp, Gg, Gg, Gg, Gg, Gg, Gg, Gg, Gg
Gg, Gg, Gg, Gg, Gg, Gg, Gg, Gs^Fp, Gs^Fp, Rr, Gs^Fp, Gg, Gg, Gg, Gg, Gg, Gg, Gg, Gg, Gg, Gg, Gg, Gg, Gs^Fp, Gg, Gs^Fp, Gg, Gg, Gg, Gg, Gg, Gs^Fp, Gs^Fp, Gs^Fp, Gs^Fp, Gg, Gg^Vh, Gg, Gg, Gg, Gg, Aa
Gg, Gg, Gg, Gg, Gg, Gg, Gg, Gg, Rr, Rr, Gg, Gg, Gg, Gg, Gg, Gg, Gg, Gg, Gg, Gg, Gg, Gg, Gg, Gg, Gg, Gg, Gg, Gg, Gg, Gg, Gs^Fp, Gs^Fp, Gs^Fp, Gs^Fp, Gg, Gg, Gg, Gg, Gg, Gg, Gg, Gg
Gg, Gg, Gg, Gg, Gs^Fp, Gs^Fp, Gg, Gg, Rr, Gg, Gg, Gg, Gg, Gg, Gg, Gg, Aa, Aa, Gg, Hh, Hh, Gg, Gg, Gg, Gg, Gg, Aa, Gg, Gg, Gg, Gg^Ve, Gs^Fp, Gs^Fp, Gs^Fp, Gg, Gg, Gg, Gg, Gg, Gg, Gg, Gg
Gg, Gg, Gs^Fp, Ch, Ch, Ch, Rr, Rr, Gg, Hh, Gg, Gg, Gg, Gg, Gg^Vh, Gg, Aa, Aa, Gg, Gs^Fp, Gs^Fp, Gg^Ve, Gs^Fp, Gg, Gg, Aa, Aa, Gg, Gg, Gs^Fp, Gs^Fp, Gs^Fp, Gs^Fp, Gg, Gg, Gg, Gg, Gg, Gg, Gg, Gg, Gg
Gg, Gg, Gs^Fp, Ch, 1 Kh, Ch, Gs^Fp, Gg, Gg, Gg, Gg, Gg, Gg, Gg, Gg, Gg, Aa, Aa, Gg, Gs^Fp, Gg, Gs^Fp, Gs^Fp, Gg, Gg, Aa, Gg, Gg, Gg, Gs^Fp, Gs^Fp, Gs^Fp, Gg, Gg, Gg, Gg, Gg, Gg, Gg, Gg, Gg, Gg
Gg, Gg, Ch, Ch, Ch, Gs^Fp, Gs^Fp, Gs^Fp, Gg, Gg, Gg, Gg, Gg, Gg, Gg, Gg, Gg, Gg, Gg, Gs^Fp, Gg, Gs^Fp, Gg, Gg, Gg, Aa, Gg, Gg, Gs^Fp, Gs^Fp, Gs^Fp, Gg, Gg^Vh, Gg, Aa, Gg, Gg, Gg, Gg, Gg, Gg, Gg
Gg, Gg, Gs^Fp, Gs^Fp, Gs^Fp, Gs^Fp, Gs^Fp, Gs^Fp, Gg, Gg, Gg, Gg, Gg, Gg, Gg, Gg, Gg, Gg, Gs^Fp, Gs^Fp, Gs^Fp, Gg, Gg, Gg, Gg, Aa, Gg, Gg, Gs^Fp, Gg^Ve, Gg, Gg, Gg, Gg, Gg, Gg, Gg, Gg, Gg, Gg, Gg, Gg
Gg, Gg, Gs^Fp, Gg^Ve, Gs^Fp, Gg, Gg^Ve, Gs^Fp, Gg, Gg, Gg, Gg, Gg, Gg, Gg, Gg, Gg, Gs^Fp, Gg^Ve, Gs^Fp, Gs^Fp, Gg, Gg, Gg, Aa, Aa, Gg, Gg, Gg, Gg, Gg, Gg, Gg, Gg, Gg, Gg, Gg, Ds, Gg, Gg, Gg, Gg
Gg, Gg, Gg, Gs^Fp, Gs^Fp, Gs^Fp, Gs^Fp, Gg, Gg, Gg, Gg, Gg, Gg, Gg, Gg, Gg, Gg, Gs^Fp, Gs^Fp, Gs^Fp, Gg, Gg, Aa, Aa, Aa, Aa, Gg, Gg, Gg, Gg, Gg, Gg, Gg, Gg, Gg, Gg, Ds, Ds, Ds, Gg, Aa, Aa
Gg, Gg, Gg, Gg, Gs^Fp, Gs^Fp, Gs^Fp, Gg, Gg, Gg, Gg, Gg, Gg, Gg, Gg, Gg, Gg, Gg, Gs^Fp, Gg, Gg, Gg, Gg, Aa, Aa, Aa, Gg, Gg, Gg, Aa, Aa, Aa, Aa, Gg, Gg, Gg, Ds, Ds, Ds, Gg, Gg, Gg
