Gg, Gs^Fp, Gs^Fp, Gs^Fp, Ds, Gg, Aa, Gg, Gg, Gg, Gg, Gg, Gs^Fp, Hh, Hh, Hh, Hh, Hh, Gg, Gg, Gg, Gg, Gs^Fp, Gg, Rr, Gs^Fp, Gs^Fp, Gs^Fp, Gs^Fp, Gs^Fp, Gs^Fp, Gs^Fp, Gs^Fp, Hh, Rr, Hh, Hh, Gg, Gg, Rr, Rr, Gg
Gg, Gg, Gg, Gg, Gg, Gg, Gg, Gg, Gg, Gg, Gg, Gg, Hh, Hh, Hh, Hh, Hh, Hh, Hh, Gg, Gg, Gg, Gs^Fp, Gg, Gg, Gs^Fp, Gs^Fp, Gs^Fp, Gs^Fp, Gs^Fp, Gs^Fp, Hh, Hh, Hh, Rr, Gg^Vh, Gg, Gg, Gg, Rr, Gg^Vh, Rr
Gg, Gg, Gg, Gg, Gg, Gg, Aa, Gg, Gg, Gg, Gg, Gg, Hh, Hh, Hh, Hh, Hh, Hh, Gg, Gg, Gg, Gg, Gs^Fp, Gg, Gg, Gs^Fp, Gs^Fp, Gs^Fp, Gs^Fp, Gs^Fp, Gg, Hh, Hh, Hh, Rr, Gg, Gg, Gg, Gg, Rr, Rr, Rr
Gg, Aa, Aa, Aa, Aa, Aa, Aa, Aa, Gg, Gg, Gg, Gg, Gg, Gg, Hh, Hh, Hh, Gg, Gs^Fp, Gs^Fp, Gg^Ve, Gs^Fp, Gs^Fp, Gg, Gg, Gg, Gs^Fp, Gg^Ve, Gs^Fp, Gg, Gg, Gg, Rr, Rr, Rr, Ch, Ch, Ch, Aa, Aa, Rr, Rr
Gg, Gg, Gg, Gg, Aa, Aa, Aa, Aa, Gg, Gg, Gg, Gg, Gg, Gg, Hh, Hh, Gs^Fp, Gs^Fp, Gs^Fp, Gg, Gs^Fp, Gs^Fp, Gg, Gg, Gg, Gg, Gg, Gg, Rr, Gg, Rr, Rr, Gg, Rr, Gg, Ch, 1 Kh, Ch, Gg, Gg, Rr, Gg
Gg, Gg, Gg^Vh, Gg, Aa, Aa, Gg, Gg, Gg, Gg, Gg, Gg, Gg, Gs^Fp, Gs^Fp, Gg, Gg, Gg, Gs^Fp, Gg, Gg, Gg, Gg, Aa, Gg, Gg, Gg, Rr, Gg, Rr, Gg, Gg, Rr, Rr, Ch, Ch, Ch, Gg, Gg, Rr, Gg, Gg
Gg, Gg, Gg, Gg, Gg, Gg, Gg, Gg, Gg, Gg, Gg, Gg, Gg, Gg^Ve, Gg, Gg, Gg, Gs^Fp, Gg, Gg, Gg, Gg, Aa, Aa, Rr, Ds, Rr, Rr, Gg, Gg, Rr, Rr, Gg, Gg, Gg, Gg, Gg, Gg, Gg, Rr, Gg, Gg
Gg, Gg, Gg, Gg, Gg, Gg, Gg, Gg, Gg, Gg, Gg, Gg, Gs^Fp, Gs^Fp, Gg, Gg, Gg, Gs^Fp, Gg, Gg, Rr, Gg, Rr, Rr, Ds, Rr, Ds, Ds, Ds, Rr, Gg, Gg, Gg, Gg, Gg, Gg, Gg, Gg, Rr, Rr, Gg, Gg
Gg, Gg, Aa, Gg, Gg, Gg, Gg, Gg, Gg, Gg, Rr, Gs^Fp, Gs^Fp, Gg, Gg, Gs^Fp, Gg, Gg, Gs^Fp, Rr, Gg^Vh, Rr, Ds, Wo, Ww, Ww, Ds, Ds, Ds, Rr, Gg, Gs^Fp, Gg, Gg, Gg, Gg, Gg, Gg, Rr, Gg, Gg, Gg
Gg, Gg, Aa, Gg, Gg, Gg, Gg, Gg, Rr, Rr, Gs^Fp, Rr, Gs^Fp, Gs^Fp, Gs^Fp, Gs^Fp, Gs^Fp, Gs^Fp, Rr, Rr, Gg, Ds, Ww, Ww, Ww, Ds, Ds, Ds, Gg, Rr, Gg, Gs^Fp, Gg^Ve, Gg, Gg, Gg, Gg, Gg^Vh, Rr, Gg, Gg, Gg
Gg, Gg, Gg, Gg, Gg, Gg, Gg, Rr, Gg, Gg, Gs^Fp, Rr, Rr, Rr, Rr, Rr, Rr, Rr, Gg, Gg, Gg, Ds, Ds, Ww, Ds, Ds, Ds, Gg, Rr, Rr, Gg, Gs^Fp, Gs^Fp, Gg, Gg, Gg, Rr, Rr, Gg, Gg, Gg, Aa
Gg, Gg, Gg, Gg, Gs^Fp, Gg, Rr, Rr, Gg, Gg, Gs^Fp, Gg^Ve, Gs^Fp, Gs^Fp, Gg, Gg, Gg, Gg, Gg, Gg, Rr, Rr, Rr, Ds, Rr, Gg, Gg^Vh, Rr, Gg, Gg, Gg, Gg, Gg, Gs^Fp, Rr, Rr, Gg, Gg, Aa, Gg, Gg, Gg
Gg, Gg, Gg, Gg, Gs^Fp, Rr, Gg^Vh, Gg, Gg, Gg, Gg, Gs^Fp, Gs^Fp, Gs^Fp, Gg, Aa, Gg, Aa, Aa, Gg, Rr, Ds, Ds, Rr, Gg, Rr, Rr, Rr, Gg, Aa, Gg, Gg, Gg, Gg, Rr, Gs^Fp, Gs^Fp, Gg, Gg, Gg, Gg, Gg
Gg, Gg, Gg, Gg, Rr, Rr, Gg, Gg, Gg, Ds, Gg, Gs^Fp, Gs^Fp, Gg, Gg, Aa, Aa, Aa, Aa, Gg, Rr, Gg, Ds, Gs^Fp, Gg^Ve, Gs^Fp, Gg, Gg, Gg, Gg, Gg, Gg, Gg, Gs^Fp, Gg, Rr, Gg, Gs^Fp, Gg, Gg, Gs^Fp, Gs^Fp
Gg, Gg, Rr, Rr, Gg, Gg, Gg, Gg, Gg, Gg, Gs^Fp, Gs^Fp, Gs^Fp, Gg, Gg, Aa, Gg, Gg, Gg, Rr, Gg, Ds, Ds, Gs^Fp, Gs^Fp, Gs^Fp, Gg, Gg, Gg, Gg, Gg, Gg, Gs^Fp, Gs^Fp, Gg, Rr, Gg, Gg, Gs^Fp, Gs^Fp, Gs^Fp, Gs^Fp
Gs^Fp, Rr, Gg, Gs^Fp, Gs^Fp, Gs^Fp, Gs^Fp, Gs^Fp, Gg, Gg, Gs^Fp, Gs^Fp, Gs^Fp, Gg, Gg, Aa, Gg, Gg^Vh, Rr, Rr, Gg, Ds, Ds, Gg, Gg, Gg, Gg, Gg, Gg, Gg, Gg, Gs^Fp, Gs^Fp, Gg, Gg, Rr, Gg, Gs^Fp, Gg^Ve, Gs^Fp, Gs^Fp, Gs^Fp
Rr, Rr, Gs^Fp, Gs^Fp, Gg, Gg, Gg, Gs^Fp, Gs^Fp, Gg, Gg, Gg, Gs^Fp, Gg, Gg, Gg, Rr, Rr, Gg, Gg, Ds, Ds, Ds, Gg, Gg, Gg, Gg, Gg, Gg, Gg, Gs^Fp, Gg^Ve, Gs^Fp, Gg, Gg, Rr, Rr, Gs^Fp, Gs^Fp, Gs^Fp, Gs^Fp, Ds
Gs^Fp, Gs^Fp, Gs^Fp, Gg, Gg, Gg, Gs^Fp, Gs^Fp, Gg, Gg, Gg, Gg, Gg, Gg, Rr, Rr, Gg, Gg, Gg, Gg, Gg, Ds, Ds, Gg, Gg, Aa, Aa, Gg, Gg, Gg, Gg, Gs^Fp, Gs^Fp, Gs^Fp, Gs^Fp, Gs^Fp, Rr, Gs^Fp, Gg, Gg, Ds, Ds
Hh, Gs^Fp, Gs^Fp, Gg, Gg, Gg, Gg^Ve, Gg, Gg, Gg, Gg, Gg, Rr, Rr, Gs^Fp, Gg, Gs^Fp, Gg, Gg, Gg, Gg, Gg, Gg, Gg, Aa, Aa, Aa, Gg, Gg, Gg, Gg, Gg, Gg, Gs^Fp, Gs^Fp, Gs^Fp, Rr, Gs^Fp, Gg, Gg, Gg, Ds
Gs^Fp, Gg^Ve, Gs^Fp, Gg, Gg, Gs^Fp, Gs^Fp, Gg, Gg, Aa, Aa, Aa, Rr, Gg, Gg, Gs^Fp, Gg^Ve, Gs^Fp, Gg, Gg, Gg, Gg, Gg, Gg, Gg, Aa, Gg, Gg, Gg, Gg, Gg, Gg, Gg, Gg, Gg, Gs^Fp, Gg, Rr, Gg, Gg, Gg, Gg
Gs^Fp, Gs^Fp, Gs^Fp, Gs^Fp, Gs^Fp, Gs^Fp, Gg, Gg, Gg, Aa, Gg, Gg, Rr, Gg, Gs^Fp, Gs^Fp, Gs^Fp, Gs^Fp, Gs^Fp, Gs^Fp, Gs^Fp, Gs^Fp, Gs^Fp, Gs^Fp, Gg, Gg, Gg^Vh, Gg, Gg, Gg, Gg, Gg, Gg, Aa, Gg, Gg, Gs^Fp, Rr, Rr, Gg, Gg, Gg
Gg, Gg, Gg, Gg, Gg, Gg, Gg, Gg, Aa, Aa, Gg, Gg, Rr, Gg, Gg, Gg, Gg, Gs^Fp, Gs^Fp, Gs^Fp, Gs^Fp, Gg, Gs^Fp, Gg^Ve, Gs^Fp, Gg, Gg, Gg, Gg, Gg, Gg^Vh, Gg, Gg, Gg, Gg, Gg, Gs^Fp, Gs^Fp, Gs^Fp, Rr, Rr, Gg
Gs^Fp, Gg, Gg, Gg, Gg, Gg, Gg, Gg, Aa, Aa, Rr, Rr, Gg, Gg, Gg, Gg, Gg, Gg, Gs^Fp, Gs^Fp, Gg, Gg, Gg, Gs^Fp, Gg, Gg, Gg, Gg, Gg, Gg, Gg, Gg, Gg, Gg, Gg, Gs^Fp, Gg^Ve, Gs^Fp, Gs^Fp, Gg, Gg, Rr
Gs^Fp, Gs^Fp, Gg, Gg, Aa, Gg, Gg, Gg, Rr, Rr, Gg, Gs^Fp, Gg^Ve, Gg, Gg, Gg, Gg, Gg, Gs^Fp, Gs^Fp, Gs^Fp, Gg, Gg, Gs^Fp, Gg^Vh, Gg, Gg, Gg, Gg, Gg, Gg, Gg, Gg, Gg, Gg, Gs^Fp, Gs^Fp, Gs^Fp, Gs^Fp, Gs^Fp, Gg, Gg
Gs^Fp, Gg, Gg, Gg, Gg, Gg, Gg, Gg, Rr, Gs^Fp, Gs^Fp, Gs^Fp, Gs^Fp, Gs^Fp, Gg, Gg, Gg, Gg, Hh, Gs^Fp, Gs^Fp, Gs^Fp, Gs^Fp, Gs^Fp, Gg, Gg, Gg, Gg, Gg, Gg, Gg, Gg, Gg, Gg, Gg, Gs^Fp, Ds, Ds, Ds, Gs^Fp, Gs^Fp, Gs^Fp
Gs^Fp, Gg, Gg, Gg, Gg, Gg, Gg, Rr, Gg, Ds, Gs^Fp, Ss, Gg, Gs^Fp, Gs^Fp, Gg, Gg, Gg, Gg, Gg, Gg, Gg, Gg, Gg, Gg, Aa, Gg, Gg, Gg, Gg, Gs^Fp, Gg, Gg, Gg, Gs^Fp, Ds, Ds, Ds, Ds, Ss, Ss, Gs^Fp
Gs^Fp, Gs^Fp, Gg, Gg, Gg, Gg, Gg, Rr, Gg, Ds, Ds, Ss, Ss, Gg, Gs^Fp, Gs^Fp, Gg, Gg, Gg, Gg, Gg, Gg, Gg, Gg, Aa, Gg, Gg, Gg, Gg, Gs^Fp, Gs^Fp, Gs^Fp, Gs^Fp, Ds, Ds, Ww, Ww, Ds, Ds, Ds, Ds, Rr
Gs^Fp, Gg^Ve, Gs^Fp, Gg, Gg, Gg, Rr, Rr, Ds, Ds, Gs^Fp, Ss, Ss, Ss, Gs^Fp, Gs^Fp, Gg, Gg, Gg, Gg, Gg, Gg, Aa, Aa, Aa, Gg, Gg, Hh, Gs^Fp, Gs^Fp, Gs^Fp, Gs^Fp, Gs^Fp, Ds, Ds, Ds, Ds, Ds, Ds, Ds, Rr, Rr
Gs^Fp, Gs^Fp, Gg, Gg, Rr, Rr, Gg, Gg, Ds, Ds, Ds, Gs^Fp, Ss, Gg, Gg^Ve, Gs^Fp, Gg, Aa, Gg, Gg, Gg, Gg, Aa, Gg, Aa, Hh, Mm, Mm, Mm, Hh, Gs^Fp, Gs^Fp, Gg, Gg, Gg, Ds, Ds, Ds, Gs^Fp, Rr, Ds, Ds
Gg, Gg, Gs^Fp, Rr, Gg, Gg, Gg, Gg, Gg, Ds, Gg, Gs^Fp, Gs^Fp, Gs^Fp, Gs^Fp, Gs^Fp, Gg, Aa, Aa, Aa, Aa, Aa, Gg, Gg, Gg, Mm, Mm, Mm, Mm, Mm, Hh, Gs^Fp, Gg, Gg, Gg, Gg, Gs^Fp, Gs^Fp, Gg^Ve, Rr, Gg, Gs^Fp
Gg, Gg, Rr, Rr, Gg, Gg, Gg, Gg, Gg, Gg, Gg, Gs^Fp, Gs^Fp, Gs^Fp, Gs^Fp, Gg, Gg, Aa, Aa, Aa, Aa, Gg, Gg, Gg, Hh, Mm, Mm, Mm, Mm, Mm, Mm, Hh, Gg, Gg, Gg, Gg, Gg^Ve, Gs^Fp, Gs^Fp, Rr, Rr, Rr
Gg, Gg, Rr, Gs^Fp, Gs^Fp, Gg, Gg, Gg, Gs^Fp, Gg, Gs^Fp, Gs^Fp, Gs^Fp, Gs^Fp, Gg, Gg, Gg, Gg, Gg, Gg, Gg, Gg, Gg, Gg, Gg, Mm, Mm, Mm, Mm, Mm, Mm, Hh, Gg, Gg, Gg, Gs^Fp, Gs^Fp, Gg, Gs^Fp, Rr, Rr, Gs^Fp
Aa, Gg, Rr, Gs^Fp, Gg^Ve, Gs^Fp, Gg, Gs^Fp, Gs^Fp, Gs^Fp, Gs^Fp, Ss, Gs^Fp, Gs^Fp, Gg^Ve, Gs^Fp, Gg, Gg, Gg, Gg^Vh, Gg, Gg, Gg, Gg, Gs^Fp, Hh, Mm, Mm, Mm, Mm, Hh, Hh, Gg, Gg, Gs^Fp, Gs^Fp, Gg, Gg, Rr, Rr, Rr, Gs^Fp
Gg, Gg, Gg, Rr, Gs^Fp, Gs^Fp, Gs^Fp, Gg^Ve, Gs^Fp, Ss, Ss, Ss, Gs^Fp, Gs^Fp, Gs^Fp, Gs^Fp, Gs^Fp, Gs^Fp, Gg, Gg, Gg, Gg, Gg, Gg, Gg^Ve, Gs^Fp, Gg, Hh, Hh, Gg, Gg, Gg, Gg, Gs^Fp, Gs^Fp, Gg, Gg, Rr, Gg, Gg, Gg, Rr
Gg, Gg, Gg, Rr, Rr, Gs^Fp, Gs^Fp, Gs^Fp, Gs^Fp, Ss, Ss, Ss, Ss, Gg, Gs^Fp, Gg, Gs^Fp, Gs^Fp, Gg, Gg, Gg, Gg, Gg, Gg, Gs^Fp, Gg, Gg, Gg, Aa, Aa, Gg, Gg, Gg, Gg, Gg, Gg, Gg, Rr, Gg, Gg, Rr, Rr
Gs^Fp, Gs^Fp, Gs^Fp, Ch, Ch, Ch, Gs^Fp, Gs^Fp, Ss, Ds, Ss, Ss, Gg, Ss, Gs^Fp, Gs^Fp, Gs^Fp, Gs^Fp, Gg, Gg, Gg, Gg, Gg, Gg, Gg, Gg, Gg, Gg, Gg, Gg, Gg, Gg, Gg, Gg, Gs^Fp, Gg, Gg, Rr, Gg^Vh, Rr, Gs^Fp, Gs^Fp
Gs^Fp, Gs^Fp, Gs^Fp, Ch, 2 Kh, Ch, Gg, Gs^Fp, Gs^Fp, Ds, Ss, Ss, Gs^Fp, Gs^Fp, Gs^Fp, Gs^Fp, Gs^Fp, Gg, Gg, Gg^Vh, Gg, Gg, Gg, Gg, Gg, Gg, Gg, Gg, Gg, Gg, Gg, Gg, Gg, Gg, Gg^Ve, Gs^Fp, Gg, Rr, Rr, Rr, Rr, Gs^Fp
Gs^Fp, Gs^Fp, Ch, Ch, Ch, Gg, Gg, Gg, Gg^Ve, Gs^Fp, Gs^Fp, Gs^Fp, Gs^Fp, Gs^Fp, Gg, Gg, Gg, Gg, Gg, Gg, Gg, Aa, Aa, Aa, Gg, Gg, Gg, Hh, Hh, Hh, Gg, Gg, Gg, Gg, Gs^Fp, Gg, Gg, Gg, Gg, Rr, Rr, Rr
Gs^Fp, Gg, Gs^Fp, Gs^Fp, Gg, Gg, Gg, Gs^Fp, Gs^Fp, Gs^Fp, Gs^Fp, Gg, Gg, Gg, Gg, Gg, Gg, Gg, Aa, Aa, Aa, Aa, Aa, Gg, Gg, Gg, Hh, Hh, Hh, Hh, Hh, Hh, Gg, Gg, Gg, Gg, Gg, Gg, Gg, Gg, Rr, Gs^Fp
Gs^Fp, Gs^Fp, Gg^Ve, Gs^Fp, Gs^Fp, Gg, Gg, Gs^Fp, Gs^Fp, Gg, Gs^Fp, Gs^Fp, Gg, Gg, Gg, Gg, Aa, Aa, Aa, Aa, Aa, Aa, Aa, Gg, Gg, Gs^Fp, Gs^Fp, Hh, Hh, Hh, Hh, Hh, Gg, Gg, Gg, Gg, Gg, Gg, Gg, Gg, Rr, Gg
Gg, Gg, Gg, Gs^Fp, Gs^Fp, Gg, Gs^Fp, Gs^Fp, Gs^Fp, Gs^Fp, Gs^Fp, Gs^Fp, Hh, Gg, Gg, Gg, Gg, Aa, Aa, Gg, Gg, Gg, Gg, Gg, Gg, Gs^Fp, Gg^Ve, Gs^Fp, Hh, Gs^Fp, Hh, Gg, Gg, Gg, Gg, Gg, Gg, Gg, Gg, Gg, Gg^Vh, Rr
Gg, Gg, Gg, Gg, Gg, Gg, Gg, Gs^Fp, Gg, Gg, Hh, Hh, Hh, Hh, Gs^Fp, Gg, Gg, Gg, Aa, Gg, Gg, Gg, Gg, Gg, Gg, Gs^Fp, Gs^Fp, Gs^Fp, Gg, Gg, Gg, Gg, Gg, Gg, Gg, Aa, Aa, Aa, Aa, Gg, Gg, Gg
