Gg, Gg, Gg, Gg, Gg, Gg, Gg, Gg, Gg, Gg, Gg, Gg, Hh, Mm, Mm, Mm, Mm, Mm, Mm, Hh, Hh, Gg, Gs^Fp, Gg, Gg, Gg, Gg, Gg, Gg, Hh, Hh, Gg, Gg, Gg, Gs^Fp, Rr, Gs^Fp, Gs^Fp, Gs^Fp, Hh, Hh, Hh
Gs^Fp, Hh, Hh, Hh, Gg, Gg, Gg, Gg, Gg, Gg, Gg, Gg, Hh, Mm, Mm, Mm, Mm, Mm, Mm, Hh, Gg, Gg, Gg, Gs^Fp, Gg^Vh, Gg, Gg, Gg, Hh, Mm, Mm, Hh, Gg, Gg^Ve, Gs^Fp, Rr, Rr, Gs^Fp, Gs^Fp, Hh, Hh, Hh
Gs^Fp, Gs^Fp, Hh, Hh, Gg, Aa, Gg, Gg, Gg, Gg, Gg, Gg, Hh, Mm, Mm, Mm, Mm, Mm, Mm, Hh, Gg, Gg, Gg, Gs^Fp, Gs^Fp, Gg, Gg, Gg, Hh, Mm, Hh, Gg, Gg, Gs^Fp, Ds, Ww, Gs^Fp, Rr, Gg, Gs^Fp, Hh, Hh
Gs^Fp, Gg, Gg, Gg, Aa, Aa, Gg, Gg, Gg, Gg, Gg, Gg, Gg, Hh, Mm, Mm, Mm, Mm, Mm, Hh, Gg, Gg, Gg, Gg, Gg, Gg, Hh, Hh, Mm, Mm, Mm, Gg, Gg, Gs^Fp, Ds, Ww, Gs^Fp, Rr, Gs^Fp, Gs^Fp, Gs^Fp, Gg
Gs^Fp, Gg, Gg, Gg, Aa, Aa, Aa, Gg, Gg, Gg, Gg, Gg, Gg, Gg, Hh, Hh, Hh^Vhh, Hh, Hh, Gg, Gg, Gs^Fp, Gg^Ve, Gs^Fp, Gg, Gg, Mm, Mm, Mm, Mm, Mm, Hh, Gg, Gg, Ds, Ds, Ds, Rr, Rr, Gs^Fp, Gs^Fp, Gs^Fp
Gs^Fp, Gg^Ve, Gg, Gg, Gg, Gg, Aa, Aa, Aa, Gg, Gg, Gg, Gg, Gg, Gg, Gg, Gg, Gg, Hh, Gg, Gg, Gg, Gs^Fp, Gs^Fp, Gs^Fp, Hh, Mm, Mm, Mm, Mm, Mm, Mm, Gg, Gs^Fp, Gs^Fp, Ds, Gg, Gg, Rr, Gs^Fp, Gg^Ve, Gs^Fp
Gs^Fp, Gs^Fp, Gs^Fp, Gs^Fp, Gg, Gg, Gg, Gg, Aa, Gg, Gg, Gg, Gs^Fp, Gg, Gg, Gs^Fp, Gg, Gg, Gg, Gg, Gg, Gg, Gs^Fp, Gg, Gg, Hh, Mm, Mm, Mm, Mm, Mm, Mm, Gg, Gg^Ve, Gs^Fp, Ch, Ch, Ch, Rr, Gs^Fp, Gs^Fp, Gs^Fp
Gg, Gs^Fp, Gs^Fp, Gs^Fp, Gs^Fp, Gs^Fp, Gg, Gg, Gg, Gg, Hh, Hh, Hh, Gs^Fp, Gs^Fp, Gs^Fp, Gg, Gg, Gg, Gg, Gg, Gg, Gs^Fp, Gg, Gg, Gg, Mm, Mm, Mm, Mm, Mm, Mm, Hh, Gs^Fp, Gs^Fp, Ch, 2 Kh, Ch, Gg, Rr, Gs^Fp, Gs^Fp
Gg, Gg, Gs^Fp, Gg, Gg, Gs^Fp, Gg^Ve, Gg, Gg, Hh, Hh, Mm, Hh, Gs^Fp, Gs^Fp, Gg, Gg, Gg, Gg, Gg, Gg, Gg, Gs^Fp, Gg, Gg, Hh, Mm, Mm, Mm, Mm, Mm, Mm, Mm, Gg, Ch, Ch, Ch, Gg, Aa, Rr, Rr, Gs^Fp
Gg, Gs^Fp, Gg, Gg, Gg, Gs^Fp, Gs^Fp, Gg, Gg, Ha, Mm, Hh, Hh, Gs^Fp, Gg^Ve, Gs^Fp, Gs^Fp, Gg, Gg, Gg, Gg, Gg, Gs^Fp, Gs^Fp, Gs^Fp, Hh, Mm, Mm, Mm, Mm, Mm, Mm, Mm, Gg, Gg, Rr, Gg, Gg, Aa, Gg, Rr, Gg
Gg, Gs^Fp, Gs^Fp, Gg, Gg, Gs^Fp, Gg, Gg, Gg, Gg, Hh, Mm, Hh, Gs^Fp, Gs^Fp, Gs^Fp, Gg, Gg, Gg^Vh, Gg, Gg, Gg, Gs^Fp, Gs^Fp, Gs^Fp, Gs^Fp, Gs^Fp, Hh, Mm, Ww, Mm, Ww, Mm, Gg, Rr, Rr, Gg, Aa, Aa, Gg, Rr, Gg
Gs^Fp, Gg, Gg, Gg, Gg, Gs^Fp, Gg, Gg, Gg, Hh, Hh, Mm, Hh, Gg, Gs^Fp, Gs^Fp, Gg, Gg, Gg, Gg, Gg, Gg, Gg, Gg, Gg, Gg, Gg^Vh, Gs^Fp, Ww, Ww, Ww, Ww, Mm, Gg, Rr, Aa, Aa, Aa, Aa, Aa, Rr, Gg
Gs^Fp, Gg, Gg, Gg, Gs^Fp, Gg, Gg, Hh, Hh, Hh, Mm, Mm, Mm, Hh, Gg, Gg, Gg, Gg, Gs^Fp, Hh, Hh, Mm, Hh, Gg, Gg, Gg, Ww, Ww, Ww, Ww, Ww, Ww, Hh, Gg^Vh, Rr, Gg, Ds, Aa, Aa, Aa, Rr, Gg
Gs^Fp, Gg, Gg, Gg, Gs^Fp, Gg, Gg, Hh, Mm, Mm, Mm, Mm, Mm, Ha, Gg, Gg, Gg, Gg, Hh, Mm, Mm, Mm, Hh, Gg, Gg, Gg, Gg, Ww, Ww, Ww, Ww, Ww, Hh, Gs^Fp, Rr, Ds, Ww, Aa, Aa, Aa, Rr, Gg
Gs^Fp, Gs^Fp, Gg, Gs^Fp, Gs^Fp, Gg, Gg, Gg, Hh, Mm, Mm, Mm, Mm, Mm, Aa, Aa, Aa, Hh, Hh, Mm, Mm, Mm, Hh, Gg, Gg, Gg, Gg, Hh, Ww, Ww, Ww, Hh, Gs^Fp, Rr, Ds, Ww, Ww, Ww, Ds, Ds, Rr, Ds
Gg, Gg, Gg, Gg, Gg, Gg, Gg^Vh, Gg, Hh, Mm, Mm, Mm, Mm, Ha, Gg, Aa, Aa, Aa, Hh, Hh, Hh, Hh, Gs^Fp, Gs^Fp, Gs^Fp, Gs^Fp, Hh, Mm, Mm, Ww, Hh, Gs^Fp, Rr, Rr, Ds, Ds, Ds, Ww, Wo, Ww, Ds, Rr
Gg, Gg, Gg, Gg, Gg, Gg, Gg, Hh, Hh, Mm, Mm, Mm, Mm, Hh, Gg, Gg, Gg, Aa, Gg, Gg, Hh, Gg, Gs^Fp, Gg^Ve, Gs^Fp, Gs^Fp, Hh, Mm, Mm, Ai, Gg, Gs^Fp, Rr, Gg, Ss, Ss, Ss, Gs^Fp, Ds, Ds, Gg, Gg
Gg, Gg, Gg, Gg, Hh, Hh, Hh, Hh, Mm, Hh, Mm, Mm, Hh, Gg, Gg, Gg, Gg, Gg, Gg, Gg, Gg, Gg, Gs^Fp, Gs^Fp, Gg, Gs^Fp, Hh, Hh, Hh, Aa, Hh, Rr, Gg, Gg, Ss, Gs^Fp, Gs^Fp, Gg, Gg, Gg, Gg, Gg
Gg, Gg, Hh, Hh, Hh, Mm, Hh, Gg, Hh, Gg, Gs^Fp, Hh, Gs^Fp, Gs^Fp, Gg, Gg, Gg, Gg, Gg, Gg, Gg, Gg, Gg, Gs^Fp, Gs^Fp, Gs^Fp, Gg^Ve, Gg, Gg, Aa, Rr, Rr, Gs^Fp, Gg, Gs^Fp, Gs^Fp, Gg, Gg, Gg, Gg, Gg, Rr
Gg, Gg, Hh, Mm, Mm, Hh, Hh, Gg, Gg, Gs^Fp, Gs^Fp, Gg, Gg, Gg^Ve, Gs^Fp, Gg, Gg, Gg, Gg, Gg, Rr, Gg, Gg, Gs^Fp, Gs^Fp, Gs^Fp, Gs^Fp, Gg, Rr, Aa, Aa, Gg, Gs^Fp, Gs^Fp, Gs^Fp, Gg, Gg, Gg, Gg, Gg, Gg, Rr
Gs^Fp, Gg, Hh, Mm, Mm, Hh, Gg, Gg, Gs^Fp, Gs^Fp, Gg, Gg, Gg, Gg, Gs^Fp, Gg, Gg, Gg, Gg, Rr, Gg, Rr, Rr, Gg, Gg, Gg, Rr, Rr, Gg, Gg, Gg, Gg, Gg, Gg, Gs^Fp, Gg, Gs^Fp, Gg, Gg, Gg, Gg, Rr
Gs^Fp, Gg, Mm, Hh, Hh, Gg, Gg, Gg, Gs^Fp, Gg^Ve, Gs^Fp, Gg, Gg, Gs^Fp, Gg, Gg, Gg, Gg, Rr, Rr, Gg, Gg, Gg, Rr, Rr, Rr, Gg, Gg, Aa, Gg, Gg, Gg, Gg, Gs^Fp, Gg^Ve, Gs^Fp, Gs^Fp, Gs^Fp, Gg, Gg, Gg, Rr
Gs^Fp, Hh, Hh, Hh, Gg, Gg, Gg, Gg, Gg, Gs^Fp, Gs^Fp, Gs^Fp, Gs^Fp, Gs^Fp, Gg, Gg, Rr, Rr, Gg, Gg, Gg, Gg, Gg, Gg, Gg, Gg, Gg^Vh, Gg, Aa, Gg, Gg, Gg, Gs^Fp, Gs^Fp, Gs^Fp, Gs^Fp, Gg, Gs^Fp, Gs^Fp, Gg, Gg, Rr
Gs^Fp, Hh, Hh, Gg, Gg, Gg, Gg, Gg, Gg, Gg, Gg, Gg, Gg^Vh, Gg, Rr, Rr, Gg, Gg, Gg, Gg, Gg^Vh, Hh, Mm, Mm, Hh, Hh, Gg, Gg, Aa, Aa, Gg, Gg, Gs^Fp, Hh, Hh, Gg, Gg, Gs^Fp, Gs^Fp, Gs^Fp, Gg, Rr
Hh, Hh, Gg^Vh, Gg, Gg, Gg, Gg, Gg, Gg, Gg, Gg, Gg, Rr, Rr, Gg, Gg, Gg, Aa, Aa, Hh, Hh, Mm, Mm, Mm, Mm, Mm, Hh, Gg, Hh, Hh, Gg, Hh, Hh, Hh, Hh, Hh, Gs^Fp, Gs^Fp, Gg, Gs^Fp, Rr, Rr
Mm, Hh, Gg, Gg, Gg, Gg, Gg, Gg, Gg, Gg, Gg, Gg, Rr, Gg, Gg, Hh, Gg, Aa, Ha, Mm, Mm, Mm, Mm, Mm, Mm, Mm, Mm, Mm, Mm, Mm, Hh, Gg, Hh, Mm, Mm, Mm, Hh, Gg, Gg, Rr, Gg, Gg
Gg, Gg, Aa, Aa, Gg, Gg, Gg, Gg, Gg, Gg, Gg, Gg, Rr, Gg, Gs^Fp, Gg, Gg, Hh, Hh, Mm, Mm, Mm, Mm, Mm, Mm, Mm, Mm, Mm, Mm, Mm, Hh, Gg, Gs^Fp, Hh, Hh, Mm, Hh, Gg, Gg, Rr, Gg, Gg
Gg, Gg, Aa, Aa, Aa, Aa, Gg, Gg, Gg, Gg, Gg, Gg, Rr, Gs^Fp, Gs^Fp, Gs^Fp, Hh, Mm, Mm, Mm, Mm, Mm, Mm, Ww, Mm, Mm, Mm, Mm, Mm, Hh, Gg^Vh, Gg, Gg, Gs^Fp, Hh, Hh, Gg, Gg, Gg^Vh, Rr, Gg, Gg
Gg, Gg, Aa, Aa, Aa, Aa, Gg, Gg, Gg, Gg, Gg, Gg, Rr, Gs^Fp, Gs^Fp, Gs^Fp, Gs^Fp, Mm, Mm, Mm, Mm, Mm, Ww, Ww, Ww, Ww, Mm, Mm, Hh, Gg, Gg, Gg, Gg, Gg, Gg, Gg, Gg, Gg, Rr, Rr, Gg, Aa
Gg, Gg, Gg, Gg, Gg, Aa, Gg, Gg, Gg, Gg, Rr, Rr, Gs^Fp, Gg^Ve, Gs^Fp, Gg, Hh, Mm, Mm, Mm, Mm, Ai, Ai, Ww, Ww, Ww, Ww, Gs^Fp, Hh, Gg, Gg, Gg, Gs^Fp, Gg, Gg, Gg, Gg, Gg, Rr, Aa, Aa, Aa
Gg, Gg, Gg, Gg, Gg, Gg, Gg, Gg, Gg^Vh, Rr, Hh, Hh, Gg, Gs^Fp, Gs^Fp, Gg, Hh, Mm, Mm, Mm, Mm, Ww, Ww, Ww, Ww, Ww, Ww, Ww, Gs^Fp, Gs^Fp, Gs^Fp, Gs^Fp, Gs^Fp, Gs^Fp, Gs^Fp, Gg, Gg, Gg, Rr, Gg, Gg, Gg
Gg, Gg, Gg, Gg, Gg, Gg, Gg, Gg, Rr, Rr, Hh, Hh, Hh, Gs^Fp, Gg, Gg, Gg, Hh, Mm, Mm, Mm, Ww, Ww^Vm, Ww, Ww, Ww, Ww, Ww, Gg^Vh, Ss, Gs^Fp, Gs^Fp, Gs^Fp, Gs^Fp, Gg, Gg, Gg, Gg, Gg, Rr, Gg, Gg
Gg, Gg, Gg, Gg, Gg, Gg, Rr, Rr, Gg, Gg, Gg, Hh, Hh, Gg, Gs^Fp, Gs^Fp, Gs^Fp, Gs^Fp, Hh, Mm, Mm, Ww, Ww, Ww, Ww, Ww, Gs^Fp, Ss, Gg, Gg, Gs^Fp, Gg^Ve, Gs^Fp, Gg, Gg, Gg, Gg, Gg, Gg, Rr, Gg, Gg
Gg, Gg, Gg, Gg, Gg^Vh, Gs^Fp, Rr, Gs^Fp, Gs^Fp, Gs^Fp, Gg, Gg, Gg, Gg, Gg, Gs^Fp, Gs^Fp, Gs^Fp, Hh, Mm, Mm, Ww, Ww, Ww, Ww, Ww, Ww, Gs^Fp, Gs^Fp, Gs^Fp, Gs^Fp, Gs^Fp, Gs^Fp, Gg, Hh, Gg, Gg, Gg, Gg, Rr, Gg^Vh, Gg
Gg, Gg, Gg, Gg, Rr, Rr, Gg, Gs^Fp, Gg, Gs^Fp, Gg, Gg, Gg, Gg, Gg, Gg, Gs^Fp, Gs^Fp, Gg, Hh, Mm, Ww, Ww, Ww, Gg, Gg, Gg, Gg, Gs^Fp, Gs^Fp, Gs^Fp, Gs^Fp, Hh, Hh, Hh, Hh, Gg, Gg, Gg, Rr, Rr, Gg
Gg, Gg, Gg, Ch, Ch, Ch, Gg, Gg, Gs^Fp, Gs^Fp, Gg, Gg, Gg, Gg, Gg, Gg, Gg, Gs^Fp, Hh, Mm, Hh, Ww, Ww, Ww, Ww, Gg, Ww, Gg, Gg, Gg, Gg, Hh, Hh, Mm, Mm, Hh, Gg, Hh, Gg, Gg, Gg, Rr
Gg, Gg, Gg, Ch, 1 Kh, Ch, Gs^Fp, Gg^Ve, Gs^Fp, Gg, Gg, Gg, Gg^Vh, Gg, Gg, Gg, Gg, Gs^Fp, Hh, Hh, Hh, Ww, Ww, Hh, Hh, Hh, Ww, Ww, Hh, Mm, Mm, Mm, Mm, Mm, Mm, Hh, Aa, Gg, Gg, Gg, Gg, Gg
Gg, Gg, Ch, Ch, Ch, Gs^Fp, Gg, Gg, Gs^Fp, Gg, Gg, Gg, Gg, Gg, Gg, Gs^Fp, Gs^Fp, Gg, Gg, Hh, Hh, Mm, Ha, Ha, Ww, Ww, Ww, Ww, Mm, Mm, Mm, Mm, Mm, Mm, Mm, Hh, Gg, Gg, Gg, Gg, Gg, Gg
Gg, Gg, Gg, Aa, Gg, Gg, Gg, Gg, Gg, Gg, Aa, Aa, Aa, Aa, Gg, Hh, Gs^Fp, Gg, Gg, Gg, Hh, Mm, Mm, Mm, Ww, Ww^Vm, Ww, Ww, Ww, Mm, Mm, Mm, Mm, Mm, Mm, Gg, Gg, Gg, Gg, Gs^Fp, Gs^Fp, Rr
Gg, Gg, Gg, Gg, Gg, Gg, Gg, Gg, Aa, Aa, Gg, Gg, Gg, Gg, Gg, Gg, Gg, Gg, Gg^Vh, Gg, Hh, Hh, Mm, Mm, Ww, Ww, Ww, Ww, Ww, Ww, Mm, Mm, Mm, Mm, Hh, Gg, Gg, Gs^Fp, Gs^Fp, Gg, Gs^Fp, Gs^Fp
Gs^Fp, Gs^Fp, Gg, Gg, Gg, Gg, Gg, Gg, Aa, Gg, Gg, Gg, Gg, Gg, Gg, Gg, Gg, Gg, Gg, Aa, Gg, Gg, Mm, Ww, Ww, Ww, Ww, Ww, Ww, Ww, Mm, Mm, Mm, Mm, Gg, Gg, Gs^Fp, Ss, Ss, Ss, Gs^Fp, Gs^Fp
Gs^Fp, Gs^Fp, Gg, Gg, Gg, Gg, Gg, Gg, Aa, Gg, Gg, Gg, Gg, Gg, Gg, Gs^Fp, Gg, Gg, Gg, Aa, Aa, Gg, Hh, Hh, Ww, Ww, Mm, Ww, Mm, Ww, Mm, Mm, Mm, Hh, Gg, Gg, Gs^Fp, Ss, Ss, Ss, Gs^Fp, Gs^Fp
