Gg, Gg, Gs^Fp, Gg, Gg, Rr, Gg, Gg, Gg, Gg, Gg, Gg, Gg, Gg, Gg, Gg, Gg, Gg, Gg, Gg, Aa, Aa, Gg, Gg, Gg, Gg, Gg, Gg, Gg, Gg, Gg, Gg, Gs^Fp, Hh, Mm, Mm, Rr, Rr, Rr, Mm, Mm, Hh
Gg, Gs^Fp, Gg^Ve, Gs^Fp, Gg, Rr, Aa, Aa, Hh, Gg, Gg, Gs^Fp, Gg, Gg, Gg, Gg, Gg, Gg, Gg, Gg, Aa, Aa, Gg, Gg, Gg, Gg, Gg, Gg, Gg, Gg, Gg, Gg, Gs^Fp, Hh, Mm, Mm, Mm, Mm, Mm, Rr, Rr, Hh
Gs^Fp, Gs^Fp, Gs^Fp, Gs^Fp, Gg, Rr, Gg, Hh, Hh, Hh, Hh, Gs^Fp, Gg, Gg, Gg, Gg, Gg, Gg, Gg^Vh, Gg, Ha, Aa, Gg, Gg, Gg, Gg, Gg, Aa, Gg, Gg, Gg, Gs^Fp, Gs^Fp, Hh, Mm, Mm, Mm, Mm, Mm, Mm, Hh, Rr
Gg, Gs^Fp, Gs^Fp, Gg, Rr, Rr, Ch, Ch, Ch, Hh, Hh, Hh, Gg, Gg, Gg, Hh, Hh, Hh, Gg, Gg, Ha, Ha, Gg, Gg, Gg, Gg, Gg, Gg, Gg, Gg, Gs^Fp, Gs^Fp, Gs^Fp, Hh, Mm, Mm, Mm, Mm, Mm, Mm, Gg, Rr
Gg, Gg, Gg, Gg, Rr, Gg, Ch, 1 Kh, Ch, Hh, Hh, Hh, Hh, Ha, Ha, Hh, Hh, Hh, Hh, Hh, Ha, Aa, Gg, Gg, Gg, Gg, Gg, Gg, Gg, Gs^Fp, Gs^Fp, Gs^Fp, Gg, Hh, Mm, Mm, Mm, Mm, Mm, Hh, Gs^Fp, Gg
Gg, Gs^Fp, Gs^Fp, Gs^Fp, Rr, Ch, Ch, Ch, Hh, Hh, Hh, Hh, Hh, Hh, Hh, Hh, Hh, Hh, Hh, Hh, Aa, Aa, Aa, Gg, Gg, Gg, Gg, Gg, Gg, Gs^Fp, Gs^Fp, Hh, Mm, Mm, Mm, Mm, Hh, Hh, Hh, Gg, Gs^Fp, Gs^Fp
Ds, Ds, Gs^Fp, Gs^Fp, Rr, Gs^Fp, Gg, Rr, Gg, Gg, Gg, Hh, Hh, Gg^Vh, Hh, Hh, Hh, Hh, Hh, Gg, Gg, Gg, Gg, Gg, Gg, Gg, Gg, Gg, Gs^Fp, Gs^Fp, Hh, Mm, Mm, Mm, Mm, Hh, Gg, Gg, Gg, Gg, Gs^Fp, Gg
Ds, Ds, Ss, Gs^Fp, Gg^Ve, Rr, Gg, Rr, Rr, Gg, Gg, Gg, Gs^Fp, Gg, Hh, Hh, Ha, Ha, Ha, Gg, Gg, Gg, Gg, Gg, Gs^Fp, Gs^Fp, Gs^Fp, Gs^Fp, Gs^Fp, Gs^Fp, Hh, Hh, Hh, Hh, Hh, Gs^Fp, Gs^Fp, Gg, Gs^Fp, Gs^Fp, Gs^Fp, Gs^Fp
Ss, Ss, Ss, Gs^Fp, Gs^Fp, Rr, Gs^Fp, Ss, Rr, Gs^Fp, Gg, Gs^Fp, Gs^Fp, Gg, Gg, Gg, Gg, Ha, Ha, Gg, Hh, Hh, Gg, Gg, Gs^Fp, Gs^Fp, Gs^Fp, Gs^Fp, Gs^Fp, Gg, Gg, Hh, Hh, Hh, Gs^Fp, Gs^Fp, Ss, Ss, Ss, Gs^Fp, Gs^Fp, Gs^Fp
Ss, Gg, Gg, Ds, Rr, Rr, Ds, Ds, Gs^Fp, Rr, Gs^Fp, Gs^Fp, Gs^Fp, Gs^Fp, Gs^Fp, Gg, Gg, Aa, Aa, Gg, Hh, Hh, Gg, Gg, Gs^Fp, Gs^Fp, Gg^Ve, Gg, Gg, Gg, Gg, Aa, Gg, Gg, Gg^Ve, Gs^Fp, Ss, Ss, Ss, Gs^Fp, Gs^Fp, Gg
Gs^Fp, Gg, Ds, Ds, Rr, Ds, Ds, Ds, Ds, Rr, Gs^Fp, Gg^Ve, Gs^Fp, Gg, Gs^Fp, Gg, Gg, Aa, Gg, Gg, Gg, Gg, Gg, Gg, Gs^Fp, Gs^Fp, Gg, Gg, Gg, Aa, Aa, Aa, Gg, Gg, Gs^Fp, Gs^Fp, Gs^Fp, Gs^Fp, Gs^Fp, Gs^Fp, Gg, Gg
Gg, Ss, Ss, Ds, Rr, Ds, Ds, Ds, Gg, Rr, Gg, Gs^Fp, Gs^Fp, Ss, Gg, Gs^Fp, Gg, Gg, Gg^Vh, Gg, Gg, Gg, Gg, Gg, Gg, Gg, Gg, Gg, Gg, Aa, Aa, Gg, Gg, Gs^Fp, Gs^Fp, Gs^Fp, Gs^Fp, Ss, Gs^Fp, Gs^Fp, Gs^Fp, Gs^Fp
Gg, Gg, Gs^Fp, Ds, Rr, Ds, Gg, Gg, Gg, Rr, Gg, Ds, Gs^Fp, Ss, Ss, Gs^Fp, Gg, Gg, Gg, Gg, Gg, Gg, Gg, Gg, Gg, Aa, Aa, Aa, Gg, Gg, Ds, Gg, Gs^Fp, Gs^Fp, Gs^Fp, Gs^Fp, Gs^Fp, Gs^Fp, Gg^Ve, Gs^Fp, Gs^Fp, Gg
Gg, Gg, Gg, Gs^Fp, Rr, Gg, Gg, Gg, Gg, Rr, Gg^Vh, Gg, Gg, Gs^Fp, Gs^Fp, Gs^Fp, Gg, Gg, Gg, Gg, Gg, Gg, Gg, Gg, Aa, Aa, Ds, Ds, Ds, Ds, Ds, Ds, Ds, Gs^Fp, Ww, Ww, Gs^Fp, Gs^Fp, Gs^Fp, Gg, Gs^Fp, Gs^Fp
Gg, Gg, Gg, Gg^Vh, Rr, Gg, Gg, Gg, Gg, Rr, Rr, Gg, Gg, Gs^Fp, Gs^Fp, Gg^Ve, Gs^Fp, Gg, Gg, Gg, Gg, Gg, Gg, Gg, Ds, Ds, Ds, Ds, Ds, Ds, Ww, Ww, Ds, Gg^Vh, Ww, Ww, Gs^Fp, Gs^Fp, Gg, Ss, Gg, Gs^Fp
Gg, Gg, Gg, Gg, Rr, Gg, Gg, Gg, Gg, Gg, Gg, Rr, Rr, Gs^Fp, Ss, Gs^Fp, Gs^Fp, Gs^Fp, Gs^Fp, Gg, Gs^Fp, Gs^Fp, Gg, Gg, Gg^Vh, Ds, Ds, Ds, Ds, Ds, Ww, Ww, Ww, Ww, Ww, Ww, Gs^Fp, Gg, Gg, Gg, Gg, Gs^Fp
Gg, Gg, Gs^Fp, Gs^Fp, Rr, Gg, Gg, Gg, Gg, Gg, Aa, Gg, Gg, Rr, Rr, Ss, Ss, Gs^Fp, Gs^Fp, Gs^Fp, Gs^Fp, Gg^Ve, Ds, Ds, Gg, Gg, Ds, Ds, Ww, Ww, Ww, Ds, Ds, Ww, Ww, Ww, Ww, Gs^Fp, Gg, Gg, Gg, Gs^Fp
Gg, Gg, Gs^Fp, Gg, Gg, Rr, Gs^Fp, Gs^Fp, Gg, Hh, Gg, Gg, Gg, Gg, Rr, Gg, Ss, Ss, Ss, Ds, Ds, Ds, Ds, Ds, Gg, Ds, Ds, Ds, Ww, Ww, Ww, Ds, Ds, Ww, Gg, Ww, Ww, Gs^Fp, Gg, Gg, Gs^Fp, Gs^Fp
Gg, Gg, Gs^Fp, Gg, Gg, Rr, Rr, Gg, Gs^Fp, Gg, Gg, Gg, Gg, Gs^Fp, Gg, Rr, Rr, Gg, Ss, Ds, Ds, Ds, Ds, Ds, Ds, Ds, Ds, Ds, Ds, Ds, Gg, Gg, Gs^Fp, Gg, Gg, Gg, Ww, Gs^Fp, Gs^Fp, Gg^Ve, Gs^Fp, Gg
Gg, Gg, Gs^Fp, Gg, Gg, Gg, Gg, Rr, Rr, Gs^Fp, Gg, Gg, Gg, Gs^Fp, Gg, Gg, Rr, Gs^Fp, Gs^Fp, Gs^Fp, Ds, Ds, Ds, Ds, Ds, Gg, Ds, Ds, Gg, Gg, Gg, Gg, Gg, Gg, Gg, Gg, Ww, Gg, Gs^Fp, Gs^Fp, Gg, Rr
Gg, Gg, Gg, Gg, Gs^Fp, Gs^Fp, Gg, Gg, Gg, Rr, Gg, Gg, Gg, Gs^Fp, Gg, Gg, Rr, Gg, Gg, Gg, Ds, Ds, Ds, Ds, Ds, Gg, Gg, Gg, Gg, Gg, Aa, Gg, Gg, Gg, Gg, Gg, Ww, Gg, Gs^Fp, Hh, Hh, Gg
Aa, Aa, Gg, Gg^Vh, Gg, Gg, Gg, Gg, Gg, Rr, Rr, Gg, Gg, Gs^Fp, Gs^Fp, Gs^Fp, Rr, Gg, Gg, Gg, Ds, Ds, Ds, Ds, Gg, Gg, Gg, Gg, Gg, Gg, Gg, Gg, Aa, Aa, Gg, Gg, Ww, Gg, Ww, Hh, Hh, Gg
Aa, Aa, Gg, Gg, Gg, Gs^Fp, Gg, Gg, Gg, Gs^Fp, Gg^Vh, Rr, Rr, Gg^Ve, Gs^Fp, Gg, Gg, Rr, Rr, Gg^Vh, Ds, Ds, Ds, Ds, Gg, Gg, Aa, Gg, Gg, Gg, Gg, Gg, Gg, Gg, Gg, Gg, Ww, Gg^Vh, Ww, Hh, Ww, Gg
Gg, Gg, Gg, Gg, Gg, Gs^Fp, Gg, Gg, Gs^Fp, Gg, Gg, Gg, Gg, Rr, Gg, Gg, Gg, Gg, Gg, Rr, Rr, Ds, Ds, Gg, Gg, Gg, Gg, Hh, Hh, Hh, Hh, Gg, Gg, Gg, Gg, Gg^Vh, Ww, Ww, Ww, Ww, Ww, Hh
Gg, Gg, Ds, Gg, Gs^Fp, Gg, Gs^Fp, Gg, Gg, Gg, Gg, Aa, Gg, Rr, Gg, Gg, Gg, Aa, Aa, Ds, Ds, Rr, Rr, Gs^Fp, Gg, Gg^Vh, Hh, Mm, Mm, Ha, Ha, Gg, Gg, Gg, Gg, Ww, Ww, Ai, Ai, Ai, Ai, Ha
Gg, Ds, Ds, Ds, Gg, Gs^Fp, Gs^Fp, Gg, Gg, Gg, Aa, Aa, Gg, Rr, Gg, Gg, Gg, Gg, Gg, Ds, Ds, Gs^Fp, Rr, Gs^Fp, Gs^Fp, Hh, Mm, Mm, Mm, Mm, Hh, Gg, Gg, Gg, Gg, Gg, Ww, Ww, Ww, Ww, Ai, Mm
Gs^Fp, Ss, Ds, Gs^Fp, Gs^Fp, Gg^Ve, Gs^Fp, Gg, Gg, Aa, Aa, Aa, Gg, Rr, Gg^Vh, Gg, Gg, Gg, Gg, Gg, Gg, Gs^Fp, Gg, Rr, Hh, Hh, Hh, Mm, Mm, Mm, Hh, Gg, Gg, Gg, Gg, Gg, Ww, Ww, Ww, Ww, Ai, Mm
Ss, Ss, Ds, Ds, Gs^Fp, Gs^Fp, Gg, Gg, Gg, Aa, Aa, Aa, Gg, Rr, Rr, Rr, Rr, Gg, Gg, Gg, Gs^Fp, Gg, Gg, Rr, Gg, Hh, Hh, Mm, Mm, Hh, Hh, Gg, Gg, Gg, Gg, Gg, Ai, Ww, Ww, Ww, Ai, Mm
Ss, Ss, Ds, Ds, Ds, Gg, Gg, Aa, Aa, Aa, Aa, Aa, Gg, Gg, Gs^Fp, Gs^Fp, Rr, Gs^Fp, Gg, Gs^Fp, Gs^Fp, Gg, Gg, Rr, Gg, Hh, Mm, Mm, Hh, Hh, Gs^Fp, Gs^Fp, Gs^Fp, Gg, Gg, Gg, Ww, Ww, Ww, Ai, Ai, Mm
Gs^Fp, Gs^Fp, Gs^Fp, Ds, Gg, Gg, Gg, Gg, Ww, Ww, Gg^Vh, Aa, Aa, Gg, Gg, Gs^Fp, Gg, Rr, Rr, Gs^Fp, Gg^Ve, Gg, Gg, Rr, Rr, Gg, Gg, Gg, Gg, Gg, Gg, Gg, Gg, Gs^Fp, Gg^Ve, Gg, Gg, Ww, Ww, Ai, Ai, Mm
Gg, Gg, Gg, Gg, Gg, Gg, Gg, Gs^Fp, Ww, Ww, Ww, Aa, Aa, Gg, Gg, Gs^Fp, Gg, Gg, Rr, Gs^Fp, Gg, Gs^Fp, Gg, Gg, Gg, Rr, Gg, Gs^Fp, Gg, Gg, Gg, Gg, Gg, Gg, Gs^Fp, Gs^Fp, Gg, Ww, Ww, Mm, Mm, Mm
Gg, Gg, Gg, Gg, Gg, Gg, Gg, Ww, Ww, Ww, Ww, Aa, Aa, Gg, Gs^Fp, Gs^Fp, Gg, Gs^Fp, Gs^Fp, Rr, Rr, Gg, Gg, Gs^Fp, Gs^Fp, Rr, Gg^Ve, Gs^Fp, Gg, Gg, Gg, Gg, Gg, Gg, Gg, Gs^Fp, Ww, Ww, Ai, Ai, Mm, Hh
Gg, Gg, Gg, Gg, Gg, Gg, Gg, Ww, Ww, Ww, Ww, Ww, Aa, Gg, Gg, Gg^Ve, Gs^Fp, Gs^Fp, Gg, Gg, Rr, Gg, Gg, Gs^Fp, Gs^Fp, Rr, Gs^Fp, Gs^Fp, Gg, Gs^Fp, Gs^Fp, Gs^Fp, Gg, Gg, Gs^Fp, Hh, Hh, Hh, Mm, Ha, Hh, Hh
Gg, Gg, Gg, Gg, Gg, Gg, Gs^Fp, Ww, Ww, Ww, Ww, Hh, Hh, Hh, Gg, Gg, Gg, Gg, Gg, Gg, Gg, Rr, Gs^Fp, Gs^Fp, Gs^Fp, Rr, Gs^Fp, Gs^Fp, Gs^Fp, Gs^Fp, Gg, Gg, Hh, Ww, Hh, Mm, Mm, Mm, Mm, Ha, Hh, Gg
Gg, Gg, Gg, Gg^Vh, Gg, Gs^Fp, Gs^Fp, Ww, Hh, Ww, Hh, Hh, Hh, Hh, Gg, Gg, Gg, Gg, Gg, Gg, Gs^Fp, Rr, Rr, Gs^Fp, Gs^Fp, Rr, Gs^Fp, Gg^Ve, Gs^Fp, Gg, Gg, Gg^Vh, Ww, Ww, Ww, Mm, Mm, Mm, Hh, Hh, Gg, Gg
Gg, Gg, Aa, Gg, Gg, Gg, Gs^Fp, Gg, Hh, Hh, Ha, Hh, Hh, Hh, Gg, Gg, Gg, Gg, Gg, Gs^Fp, Gs^Fp, Gs^Fp, Rr, Gg, Gs^Fp, Rr, Rr, Ch, Ch, Ch, Gg, Ww, Ww, Ww, Ww, Ww, Mm, Mm, Hh, Gg, Gg, Gg
Gg, Gg, Aa, Gg, Gg, Gg, Gg, Gg, Gg^Vh, Hh, Ha, Hh, Hh, Gg, Gg, Gg, Gg, Gg, Gs^Fp, Gs^Fp, Gs^Fp, Gs^Fp, Rr, Gg, Gg, Gg, Gg, Ch, 2 Kh, Ch, Gg, Ww, Ww, Ww, Ww, Ww, Mm, Hh, Hh, Gg, Gg, Gg
Gg, Gg, Aa, Gg, Gg, Gg, Gg, Gg, Gg, Gg, Ha, Hh, Hh, Hh, Hh, Gg, Gg, Gg, Gg, Gg, Gg, Gg, Rr, Gg^Vh, Gg, Gg, Ch, Ch, Ch, Gg, Gg, Gs^Fp, Ww, Ww, Ww, Hh, Hh, Hh, Gg^Vh, Gg, Gg, Gg
Gg, Aa, Aa, Gg, Gg, Gg, Gg, Gg, Gg, Aa, Gg, Aa, Ha, Ha, Ha, Hh, Gg, Hh, Gg, Gg, Gg, Gg, Gg, Rr, Rr, Gg, Gg, Gg, Gg, Gg, Gg, Gg, Gs^Fp, Ww, Gg, Ww, Gs^Fp, Gg, Gg, Gg, Gs^Fp, Gg
Gg, Gg, Aa, Aa, Aa, Aa, Aa, Aa, Aa, Aa, Aa, Aa, Aa, Ha, Ha, Hh, Hh, Hh, Gg, Gg, Gg, Gg, Gg, Gg, Rr, Gg, Gg, Gg, Gg, Gg, Gg, Gg, Gg, Gs^Fp, Gs^Fp, Ww, Gg, Gg, Gg, Gg, Gg, Gg
Gg, Gg, Gg, Gg, Aa, Gg, Aa, Aa, Aa, Aa, Aa, Aa, Aa, Ha, Hh, Hh, Hh, Gg, Gg, Aa, Gg, Gg, Gg, Gg, Rr, Gg, Gg, Gg, Gg, Gg, Gg, Gg, Gg, Gg, Gg, Ww, Gg, Gg, Gg, Gg, Gg, Gg
Gg, Gg, Gg, Aa, Aa, Aa, Aa, Aa, Aa, Gg, Gg, Gg, Gg, Gg, Gg, Gg, Gg, Gg, Gg, Gg, Aa, Aa, Gg, Gg, Rr, Gg, Gg, Gg, Gg, Gg, Gg, Gg, Gg, Gg, Gg, Ww, Ww, Gg, Gg, Gg, Gg, Ds
