Dd, Dd, Dd, Dd, Dd, Gs^Ft, Gs^Ft, Dd, Dd, Dd, Dd, Dd, Gs^Ft, Gs^Ft, Gs, Dd, Ww, Dd, Dd, Dd, Dd, Dd, Dd, Hd, Gs, Gs, Gs, Ww, Ww, Ww, Ww, Ww, Ww, Ww, Ww, Ww, Ww, Ww, Rd, Ww, Gs, Gs^Ft
Dd, Dd, Dd, Dd, Dd, Gs^Ft, Gs^Ft, Dd, Dd, Hd, Hd, Dd, Dd, Gs^Ft, Gs^Ft, Dd, Dd, Dd, Dd, Dd, Dd, Dd, Hd, Hd, Gs, Gs, Gs, Dd, Dd, Gs, Ww, Ww, Ww, Ww, Ww, Ww, Ww, Ww, Ch, Ww, Gs, Gs
Dd, Dd, Dd, Dd, Dd, Hd, Hd, Hd, Dd, Hd, Dd, Dd, Dd, Dd, Gs^Ft, Dd, Dd, Dd, Dd, Dd, Dd, Gs^Ft, Hd, Hd, Gs, Gs, Gs^Ft, Gs, Gs, Gs, Dd, Ww, Ww, Ww, Ww, Ww, Ww, Ww, Ww, Rd, Gs, Gs
Gs^Ft, Gs^Ft, Gs^Ft, Ch, Ch, Ch, Hd, Hd, Hd, Hd, Hd, Gs^Ft, Gs^Ft, Gs^Ft, Gs^Ft, Dd, Dd, Gs^Ft, Gs^Ft, Gs^Ft, Dd, Dd, Hd, Gs^Ft, Gs^Ft, Gs^Ft, Gs^Vht, Gs^Ft, Gs, Gs, Gs, Dd, Ww, Ww, Ww, Ww, Ww, Ww, Ww, Rd, Gs, Gs
Gs, Gs, Gs, Ch, 1 Kh, Ch, Hd, Hd, Hd, Hd, Hd, Gg^Vh, Gs^Ft, Gs^Ft, Gg^Vh, Ww, Ww, Dd, Gs, Gs^Ft, Gs^Ft, Dd, Dd, Dd, Dd, Dd, Dd, Gs^Ft, Gs, Gs, Gs, Gs, Gs, Ww, Ww, Ww, Ww, Ww, Ww, Rd, Gs, Gs
Gs, Gs, Ch, Ch, Ch, Hd, Hd, Hd, Hd, Hd, Hd, Gs, Gs, Gs, Dd, Ww, Ww, Dd, Gs, Gs^Ft, Gs^Vht, Dd, Hd, Dd, Dd, Dd, Dd, Gs^Ft, Gs^Ft, Gs, Gs, Gs, Gs, Gs, Dd, Ww, Ww, Ww, Rd, Rd, Gs^Ft, Gs
Gs, Gs, Gs^Ft, Rd, Hd, Hd, Hd, Hd, Hd, Hd, Hd, Gs, Gs, Gs, Dd, Ww, Ww, Dd, Gs, Gs^Ft, Gs^Ft, Gs^Ft, Gs^Ft, Dd, Dd, Dd, Dd, Gs^Ft, Gs, Gs, Gs, Gs, Gs, Gs, Gs^Ft, Dd, Dd, Dd^Vda, Rd, Dd, Gs^Ft, Gs
Gs, Gs^Ft, Gs^Vht, Rd, Rd, Hd, Hd, Hd, Gs, Gs, Gs, Gs, Gs, Gs, Ww, Ww, Dd, Gs^Ft, Dd, Gs^Ft, Gs, Gs^Ft, Gs^Ft, Gs^Ft, Dd, Dd, Dd, Dd, Gs^Ft, Gs^Ft, Dd, Gs^Ft, Gs, Gs^Ft, Dd, Dd, Dd, Dd, Rd, Dd, Gs^Ft, Gs^Ft
Gs, Gs, Gs^Ft, Gs^Ft, Rd, Dd, Gs^Ft, Gs^Ft, Gs, Gs, Gs, Gs, Gs, Gs, Gs^Ft, Dd, Dd, Dd, Dd, Dd, Gs^Ft, Gs, Gs^Ft, Gs, Gs^Ft, Dd, Dd, Dd, Dd, Gs^Ft, Gs^Ft, Dd, Dd, Dd, Dd, Dd, Dd, Dd, Rd, Dd, Gs^Ft, Gs^Ft
Gs^Ft, Dd, Dd, Dd, Rd, Dd, Gs^Ft, Gs^Vht, Gs^Ft, Gs, Gs, Gs, Gs, Gs, Dd, Dd, Dd, Dd, Dd, Dd, Dd, Gs^Ft, Gs^Ft, Gs, Gs^Ft, Dd, Dd, Dd, Dd, Dd, Dd, Dd, Dd^Vda, Dd, Dd, Dd, Dd, Dd, Rd, Dd, Gs^Ft, Gs^Ft
Dd, Dd, Dd, Dd, Dd, Rd, Dd, Dd, Gs^Ft, Gs^Ft, Gs^Ft, Gs^Ft, Gs^Ft, Gs^Ft, Gs^Ft, Dd, Dd, Dd, Dd, Dd, Dd, Dd, Dd, Gs^Ft, Dd, Dd, Dd^Vda, Dd, Hd, Hd, Dd, Dd, Dd, Dd, Dd, Dd, Dd, Dd, Rd, Dd, Gs^Ft, Gs^Ft
Dd, Dd, Dd, Dd, Dd, Rd, Rd, Dd, Dd, Dd, Dd, Dd, Gs^Ft, Gs^Ft, Dd, Dd, Dd, Dd, Dd, Dd, Ww, Dd, Dd, Dd, Dd, Dd, Hd, Hd, Hd, Hd, Dd, Dd, Dd, Dd, Dd, Dd, Dd, Dd, Rd, Gs^Ft, Gs^Ft, Gs^Ft
Dd, Dd, Dd, Dd, Dd, Ww, Dd, Rd, Rd, Dd, Dd, Dd, Dd, Gs^Ft, Dd, Dd, Dd^Vda, Ww, Ww, Ww, Ww, Ww, Dd^Vda, Dd, Dd, Dd, Hd, Hd, Hd, Hd, Hd, Hd, Gs^Ft, Gs^Ft, Dd, Dd, Gs^Ft, Rd, Gs^Ft, Gs^Ft, Gs, Gs^Ft
Dd, Dd, Dd, Ww, Ww, Dd, Dd, Dd, Dd, Rd, Dd, Dd, Dd, Gs^Ft, Dd, Dd, Ww, Ww, Ww, Ww, Ww, Ww, Ww, Ww, Ww, Dd, Hd, Md, Md, Hd, Hd, Hd, Gg^Vh, Gs, Ww, Gs^Ft, Ww, Ww^Bw|, Ww, Ww, Gs, Gs
Ww, Ww, Ww, Ww, Ww, Gs^Ft, Gs^Ft, Gs^Ft, Dd, Rd, Dd, Dd, Dd, Dd, Ww, Ww, Ww, Ww, Ww, Ww, Ww, Ww, Ww, Ww, Ww, Dd, Hd, Hd, Hd, Ww, Ww, Ww, Ww, Hd, Ww, Ww, Rd, Rd, Dd, Ww, Ww, Dd
Dd, Ww, Ww, Ww, Ww, Gs^Ft, Gs^Ft, Gs, Gs^Ft, Rd, Dd, Dd, Dd, Dd, Ww, Ww, Ww, Ww, Ww, Ww, Ww, Ww, Ww, Dd, Ww, Dd, Hd, Ww, Md, Ww, Ww, Ww, Ww, Ww, Ww, Dd, Rd, Dd, Dd, Ww, Ww, Dd
Ww, Ww, Ww, Ww, Dd, Dd, Dd, Gs^Ft, Gs, Re, Rd, Gs^Ft, Dd, Dd, Ww, Ww, Ww, Ww, Ww, Ww, Dd, Dd, Ww, Dd, Ww, Hd, Ww, Ww, Ww, Ww, Ww, Ww, Ww, Ww, Hd, Dd, Rd, Dd, Dd, Dd^Vda, Ww, Ww
Dd, Ww, Ww, Ww, Dd, Dd, Dd, Dd, Dd, Gs^Ft, Rd, Dd, Dd, Dd, Dd, Ww, Ww, Ww, Ww, Dd, Dd, Ww, Dd, Dd, Ww, Ww, Ww, Ww, Ww, Ww, Ww, Ww, Ww, Ww, Rd, Rd, Dd, Dd, Dd, Ww, Ww, Ww
Dd, Dd, Ww, Dd, Dd, Dd, Dd, Dd^Vda, Dd, Dd, Rd, Dd, Dd, Dd, Gs, Dd, Dd, Dd, Dd, Gs^Ft, Gs^Ft, Ww, Dd, Hd, Ww, Ww, Ww, Ww, Ww, Ww, Ww, Ww, Hd, Hd, Rd, Dd, Dd, Dd, Dd, Dd, Ww, Dd
Dd, Dd, Dd, Dd, Dd, Dd, Dd, Dd, Dd, Dd, Dd, Rd, Dd, Dd, Gs, Gs, Dd, Dd, Dd, Gs^Ft, Gs^Vht, Ww, Hd, Ww, Ww^Vm, Ww, Ww, Ww, Ww, Ww, Ww, Ww, Re, Rd, Gs^Ft, Gs^Ft, Dd, Dd, Dd, Dd, Dd^Vda, Dd
Dd, Dd, Dd, Dd, Dd, Dd, Dd, Dd, Dd, Dd, Dd, Rd, Rd, Dd, Dd, Dd, Dd, Dd, Dd, Ww, Ww, Ww, Hd, Ww, Ww, Ww, Ww, Ww, Ww, Ww, Ww, Re, Gs, Gs, Gs^Ft, Gs^Ft, Dd, Dd, Dd, Dd, Dd, Dd
Dd, Gs^Ft, Gs^Ft, Gs^Ft, Gs^Ft, Dd, Dd, Dd, Dd, Gs^Ft, Gs^Ft, Gs^Ft, Dd, Rd, Rd, Dd, Dd^Vda, Dd, Gs^Ft, Ww, Ww, Ww, Md, Ww, Ww, Ww, Ww, Ww, Ww, Ww, Gs, Re, Gs, Gs^Ft, Gs^Ft, Dd, Dd, Dd, Dd, Dd, Dd, Dd
Gs^Ft, Gs^Vht, Gs^Ft, Gs, Gs^Ft, Gs^Ft, Dd, Gs^Ft, Gs, Gs, Gs^Ft, Gs^Ft, Gs^Ft, Gs^Ft, Rd, Gs^Ft, Ww, Ww, Ww, Ww, Ww, Ww, Ww, Ww, Md, Ww, Ww, Ww, Ww, Ww, Gs, Re, Gs^Ft, Gs^Vht, Dd, Dd, Dd, Dd, Dd, Dd, Dd, Dd
Gs^Ft, Gs^Ft, Gs^Ft, Gs^Ft, Gs^Ft, Dd, Gs^Ft, Gs^Ft, Gs, Gs, Gs, Gs^Ft, Hd, Gs, Rd, Gs, Gs, Gs, Ww, Ww, Ww, Ww, Ww, Ww, Md, Ww, Ww, Ww, Ww, Gs, Re, Re, Gs^Ft, Ww, Dd, Gs^Ft, Dd, Dd, Dd, Gs^Ft, Dd, Hd
Dd, Dd, Dd, Hd, Dd, Dd, Gs^Ft, Gs^Ft, Gs, Gs, Gs, Hd, Hd, Gs, Gs, Re, Gs, Gs, Hd, Hd, Md, Ww, Ww, Md, Md, Ww, Ww, Ww, Ww^Bw/, Re, Dd, Dd, Ww, Ww, Ww, Gs^Ft, Gs^Ft, Gs^Ft, Gs^Ft, Hd, Hd, Hd
Dd, Dd, Dd, Dd, Gs^Ft, Gs^Ft, Gs^Vht, Gs, Gs, Gs, Hd, Hd, Hd, Gs, Gs, Re, Gs, Gs, Hd, Hd, Md, Md, Ww, Ww, Ww, Ww, Dd^Vdt, Rd, Gs^Ft, Ww, Ww, Ww, Ww, Ww, Dd, Gs, Gs^Ft, Gs^Ft, Hd, Hd, Hd, Hd
Gs^Ft, Dd, Dd, Dd, Gs^Ft, Gs^Ft, Gs^Ft, Gs^Ft, Gs^Ft, Gs, Gs, Hd, Hd, Gs, Gs, Re, Gs, Gs, Gs, Hd, Hd, Md, Ww, Ww, Ww, Ww, Ww, Rd, Ww, Ww, Ww, Ww, Ww, Ww, Ww, Gs^Ft, Dd, Dd, Hd, Hd, Hd, Hd
Gs^Ft, Gs^Ft, Gs^Ft, Dd, Dd, Gs^Ft, Gs^Ft, Dd, Gs^Ft, Gs^Ft, Gs^Ft, Hd, Gs, Gs, Gs, Re, Gs, Gs, Hd, Hd, Hd, Dd^Vdt, Ww, Ww, Ww, Ww, Rd, Ch, Dd, Ww, Ww, Ww, Ww, Ww, Ww, Gs^Ft, Gs^Ft, Dd, Hd, Hd, Hd, Dd
Gs, Gs, Gs, Gs^Ft, Gs^Ft, Gs^Ft, Gs^Ft, Gs^Ft, Dd, Dd, Dd, Gs^Ft, Gs, Gs, Gs, Re, Gg^Vh, Gs, Hd, Hd, Hd, Hd, Ww, Ww, Dd, Rd, Gs^Ft, Dd, Dd, Ww, Ww, Wo, Ww, Ww, Ww, Gg^Vh, Gs^Ft, Dd, Dd, Dd, Gs^Ft, Gs^Ft
Gs^Ft, Gs, Gs, Gs, Gs^Ft, Dd, Gs^Ft, Dd, Dd, Dd, Dd, Gs^Ft, Gs^Ft, Gs^Ft, Gs, Re, Re, Gs, Gs, Hd, Dd, Dd, Dd, Dd, Dd, Rd, Dd, Dd, Ww, Ww, Ww, Ww, Ww, Ww, Ww, Gs^Ft, Dd, Dd, Dd, Dd, Dd^Vda, Dd
Gs^Ft, Gs, Gs, Gs, Gs^Ft, Gs^Ft, Dd, Dd, Dd, Dd, Dd, Dd, Gs^Ft, Gs^Ft, Gs, Gs, Re, Gs, Gs, Gs^Ft, Dd, Dd, Dd, Dd, Rd, Rd, Dd, Ww, Ww, Ww, Wo, Ww, Ww, Ww, Ww, Dd, Dd, Dd, Dd, Dd, Ww, Ww
Dd, Gs, Gs, Gs, Gs, Gs^Ft, Dd, Dd, Dd^Vda, Dd, Dd, Dd, Gs^Ft, Gs, Gs^Ft, Hd, Hd, Rd, Gs^Ft, Gs^Ft, Gs^Vht, Gs^Ft, Gs^Ft, Rd, Dd, Gs^Ft, Ww, Ww, Ww, Wo, Ww, Ww, Ww, Ww, Ww, Ww, Ww, Ww, Ww, Ww, Ww, Ww
Dd, Gs, Gs, Hd, Hd, Hd, Hd, Dd, Dd, Dd, Gs^Ft, Gs^Ft, Gs, Gs, Hd, Hd, Hd, Rd, Rd, Gs^Ft, Gs^Ft, Gs, Gs, Re, Rd, Dd, Ww, Ww, Ww, Ww, Ww, Ww, Ww, Ww, Ww, Ww, Ww, Ww, Ww, Ww, Ww, Ww
Gs^Ft, Gs, Hd, Hd, Hd, Hd, Hd, Dd, Dd, Dd, Gs^Ft, Gs, Gs, Hd, Hd, Hd, Hd, Hd, Gs^Ft, Rd, Rd, Gs, Gs, Gs, Rd, Dd, Dd, Dd^Vda, Ww, Ww, Ww, Ww, Ww, Ww, Ww, Ww, Ww, Ww, Ww, Ww, Ww, Ww
Gs, Gs, Gs, Gs, Dd, Hd, Dd, Dd, Dd, Dd, Gs^Ft, Gs, Gg^Vh, Hd, Hd, Md, Hd, Hd, Gs^Ft, Gs^Ft, Dd, Rd, Gs^Ft, Gs^Ft, Rd, Dd, Dd, Gs^Ft, Ww, Ww, Ww, Ww, Ww, Ww, Gs, Gs, Gs, Dd, Ww, Ww, Ww, Ww
Gs, Gs, Gs, Gs, Dd, Dd, Dd, Dd, Dd, Dd, Gs^Ft, Gs^Ft, Gs, Hd, Hd, Hd, Hd, Gs, Gs, Gs, Dd, Rd, Dd, Dd, Rd, Dd, Dd, Gs, Dd, Ww, Ww, Ww, Ww, Dd, Dd, Ch, Ch, Ch, Dd, Ww, Ww, Ww
Gs, Gs, Gs, Gs, Dd, Dd^Vda, Dd, Dd, Dd, Dd, Gs^Ft, Gs, Gs, Hd, Hd, Hd, Gs, Gs, Gs, Gs^Ft, Dd, Rd, Dd, Dd, Dd, Rd, Rd, Gs, Ww, Ww, Ww, Ww, Ww, Gs, Dd, Ch, 2 Kh, Ch, Dd, Dd^Vda, Dd, Dd
Gs, Gs, Gs, Gs^Ft, Gs^Ft, Dd, Dd, Dd, Gs^Ft, Gs^Ft, Gs, Gs, Gs, Gs, Gs, Gs, Gs, Gs, Gs, Gs^Ft, Dd, Rd, Rd, Dd, Dd, Dd, Rd, Gs, Ww, Ww, Ww, Ww, Ww, Gg^Vh, Ch, Ch, Ch, Dd, Dd, Dd, Gs^Ft, Gs^Ft
Hd, Gs, Gs, Gs, Gs^Ft, Gs^Ft, Dd, Dd, Ww, Ww, Dd, Gs, Gs, Gs, Gs, Gs, Gs^Ft, Gs, Gg^Vh, Ww, Dd, Dd, Dd, Rd, Dd, Gs^Ft, Re, Dd, Ww, Ww, Ww, Ww, Rd, Re, Gs^Ft, Dd, Dd, Dd, Dd, Dd, Dd, Gs^Ft
Hd, Gs, Gs, Gs, Gs^Ft, Ww, Dd, Ww, Dd, Ww, Gg^Vh, Ww, Gs, Gs, Gs^Ft, Gs^Ft, Gs^Ft, Gs^Ft, Gs^Ft, Ww, Dd, Dd, Dd, Rd, Dd, Gs^Ft, Re, Dd, Ww, Ww, Ww, Ww, Re, Gs, Gs, Gs^Ft, Dd, Dd, Dd, Dd, Dd, Dd
Hd, Gs, Gs, Gs, Gg^Vh, Ww, Ww, Ww, Dd, Gs^Ft, Ww, Gs, Gs, Gs^Ft, Dd, Dd, Dd, Dd, Ww, Ww, Dd, Dd, Dd, Rd, Rd, Gs^Ft, Re, Ww, Ww, Ww, Ww, Gs, Re, Gs, Gs^Ft, Gs^Ft, Dd, Dd^Vda, Dd, Dd, Dd, Dd
Hd, Gs, Gs, Gs, Gs, Dd, Ww, Ww, Dd, Dd, Gs^Ft, Gs, Gs, Gs^Ft, Dd, Dd, Dd, Dd, Gs^Ft, Ww, Ww, Ww, Ww, Dd, Dd, Re, Rd, Rd, Ww, Ww, Rd, Rd, Gs^Ft, Gs^Ft, Dd, Dd, Dd, Dd, Dd, Dd, Dd, Dd
