Gs, Gs, Gs, Gs, Gs^Ft, Gs^Ft, Dd, Dd, Dd, Dd, Dd, Dd, Dd, Dd, Hd, Ww, Ww, Md, Md, Ww, Ww, Ww, Ww, Md, Md, Md, Md, Md, Ww, Ww, Ww, Ww, Hd, Gs^Ft, Gs, Gs, Gs^Ft, Dd, Dd, Dd, Dd, Dd
Gs, Gs, Gs, Gs^Ft, Gs^Ft, Gs^Ft, Dd, Dd, Dd, Dd, Dd, Dd, Dd, Dd, Dd, Hd, Hd, Hd, Hd, Ww, Ww, Ww, Ww, Md, Md, Md, Rd, Rd, Md, Md, Hd, Ww, Hd, Gs^Ft, Gs^Ft, Gs^Ft, Dd, Dd, Dd, Dd, Dd, Dd
Gs, Gs^Ft, Gs^Ft, Dd, Dd, Dd, Dd, Dd, Dd, Dd, Gs^Ft, Gs^Ft, Dd, Dd, Dd, Dd, Dd, Dd, Ww, Ww, Hd, Dd^Vdt, Hd, Md, Rd, Rd, Md, Md, Md, Md, Hd, Hd, Gs, Gs, Gs^Ft, Dd, Dd, Dd, Dd, Dd, Dd, Dd
Gs^Ft, Gs^Ft, Dd, Ch, Ch, Ch, Dd, Dd, Dd, Dd, Gs^Ft, Dd, Dd, Dd, Dd, Gs, Dd, Dd^Vda, Dd, Dd, Gs^Ft, Gs^Ft, Hd, Md, Rd, Md, Md, Md, Md, Hd, Hd, Gs^Ft, Gs, Gs^Ft, Dd, Dd, Dd, Dd, Dd, Dd, Dd, Gs^Ft
Gs^Ft, Gs^Ft, Gs^Ft, Ch, 1 Kh, Ch, Gs^Ft, Gs^Ft, Gs^Ft, Gs, Gs^Ft, Dd, Hd, Hd, Hd, Dd, Dd, Dd, Dd, Dd, Gs^Ft, Hd, Hd, Md, Rd, Md, Md, Md, Hd, Hd, Gs^Ft, Gs^Ft, Gs^Ft, Dd, Dd, Dd, Dd, Dd, Dd, Dd, Dd, Hd
Gs^Ft, Gs^Ft, Ch, Ch, Ch, Gs^Ft, Gs, Gs, Gs, Gs, Hd, Hd, Hd, Hd, Md, Hd, Dd, Dd, Dd, Gs^Ft, Gg^Vh, Hd, Rd, Rd, Md, Md, Md, Hd, Hd, Dd, Gs^Ft, Gs^Ft, Gs^Vht, Dd, Dd, Dd, Dd, Dd, Dd, Dd, Dd, Dd
Gs, Gs^Ft, Dd, Dd, Dd, Rd, Rd, Gs^Ft, Gs, Gs, Hd, Hd, Hd, Hd, Md, Md, Hd, Hd, Gs^Ft, Gs, Rd, Rd, Hd, Md, Md, Md, Md, Hd, Hd, Dd^Vda, Dd, Gs^Ft, Gs^Ft, Dd, Dd, Dd, Dd, Dd, Dd, Dd, Dd, Gs^Ft
Gs, Gs^Ft, Dd, Dd^Vda, Dd, Dd, Dd, Rd, Gs^Ft, Gs, Gs, Hd, Hd, Hd, Hd, Hd, Hd, Hd, Hd, Hd, Rd, Hd, Md, Md, Md, Md, Md, Hd, Hd, Dd, Dd, Gs^Ft, Dd, Dd, Dd, Dd, Dd, Dd, Dd, Dd, Dd, Gs^Ft
Gs, Gs, Dd, Dd, Dd, Dd, Dd, Rd, Gs^Ft, Gs, Gs, Hd, Hd, Md, Md, Md, Hd, Hd, Hd, Hd, Rd, Md, Md, Md, Md, Md, Md, Md, Hd, Hd, Dd, Gs^Ft, Gs^Ft, Dd, Dd, Dd, Dd, Dd, Dd, Dd, Dd, Gs^Ft
Gs, Gs^Ft, Dd, Dd, Gs, Dd, Dd, Rd, Re, Gg^Vh, Gs, Hd, Hd, Md, Md, Hd, Dd^Vdt, Hd, Rd, Rd, Hd, Md, Md, Md, Md, Md, Md, Md, Hd, Hd, Dd, Dd, Dd, Dd, Dd, Dd, Dd, Dd, Dd, Dd, Dd, Gs^Ft
Gs, Dd, Dd, Dd, Dd, Dd, Dd, Dd, Gs, Re, Gs, Gs, Hd, Hd, Hd, Hd, Hd, Re, Gs^Ft, Hd, Hd, Md, Md, Md, Md, Md, Md, Hd, Hd, Hd, Dd, Dd, Dd, Dd, Dd, Dd, Dd, Dd, Dd, Dd, Dd, Gs^Ft
Gs^Ft, Dd, Dd, Dd, Dd, Dd, Dd, Dd, Gs, Re, Re, Gs, Gs, Hd, Hd, Gs^Ft, Rd, Rd, Dd, Dd, Hd, Hd, Hd, Md, Md, Md, Hd, Hd, Hd, Hd, Dd, Dd, Dd, Dd, Dd^Vda, Dd, Dd, Dd, Dd, Dd, Dd, Gs^Ft
Gs^Ft, Dd, Dd, Gs, Dd, Dd, Dd, Gs^Ft, Gs, Gs, Re, Gs, Gs, Gs, Gs^Ft, Rd, Dd, Dd, Dd, Dd, Hd, Hd, Hd, Hd, Hd, Hd, Hd, Hd, Hd, Dd, Dd, Dd, Gs^Ft, Dd, Ww, Dd, Dd^Vda, Dd, Dd, Dd, Rd, Rd
Gs^Ft, Dd, Dd^Vda, Dd, Dd, Dd, Dd, Dd, Dd, Ww, Gs, Re, Re, Re, Rd, Rd, Dd, Dd, Dd^Vda, Dd, Dd, Dd, Dd, Gs^Ft, Gs, Gs^Ft, Dd, Dd, Hd, Gs, Dd, Dd, Gs^Ft, Dd, Dd, Dd, Dd, Dd, Dd, Rd, Dd, Dd
Gs^Ft, Dd, Dd, Dd, Dd, Dd, Dd, Ww, Ww, Ww, Ww, Ww, Re, Gs, Gs^Ft, Dd, Dd^Vda, Dd, Dd, Dd, Dd, Dd, Gs^Ft, Gs^Ft, Gs, Gs^Ft, Dd, Dd, Dd, Dd, Dd, Dd, Gs^Ft, Gs, Gs, Gs^Ft, Gs, Gs^Ft, Dd, Rd, Dd, Dd
Gs^Ft, Gs^Ft, Dd, Dd, Dd, Gs^Ft, Gs^Ft, Dd, Dd, Ww, Ww, Ch, Rd, Gs, Gs^Ft, Dd, Dd, Dd, Hd, Dd, Dd, Dd, Gs^Ft, Gs^Ft, Gs, Gs^Ft, Dd, Dd^Vda, Dd, Dd, Dd, Dd, Gs^Ft, Gs^Ft, Gs, Gs, Gs, Gs, Dd, Rd, Rd, Dd
Gs, Gs, Gs^Ft, Gs, Gs, Gs, Gs^Ft, Gs, Gs, Gg^Vh, Dd, Re, Gs, Gs^Ft, Dd, Hd, Hd, Hd, Hd, Hd, Gs^Ft, Dd, Dd, Gs^Ft, Gs^Ft, Dd, Dd, Dd, Dd, Dd, Dd, Dd, Gs^Ft, Gs^Ft, Gs, Gs, Gs, Gs, Dd, Dd, Re, Dd
Gs, Gs, Gs, Gs, Gs, Hd, Gs, Gs, Gs, Gs, Re, Re, Gs^Ft, Gs^Ft, Hd, Md, Md, Md, Hd, Hd, Dd, Dd, Dd, Dd, Dd, Dd, Dd, Dd, Dd, Dd, Dd, Dd, Gs^Ft, Gs^Ft, Gs, Gs, Gs^Ft, Gs^Ft, Dd, Dd, Dd, Rd
Gs, Gs, Gs, Gs, Hd, Hd, Hd, Hd, Gs, Re, Gs, Re, Gs^Ft, Dd, Hd, Md, Md, Md, Md, Hd, Hd, Dd, Dd, Dd, Dd, Dd, Gs^Ft, Gs^Ft, Gs^Ft, Dd, Dd, Dd, Gs^Ft, Gs^Ft, Gs, Gs, Gs, Gs^Ft, Dd, Dd, Dd, Rd
Gs, Gs, Gs^Ft, Gs, Hd, Hd, Hd, Hd, Gs^Ft, Re, Gs, Rd, Gs^Ft, Gs^Ft, Hd, Hd, Md, Md, Md, Md, Hd, Dd, Dd^Vda, Dd, Dd, Dd, Gs^Ft, Gs, Gs^Ft, Gs^Ft, Dd, Dd, Dd, Dd, Dd, Gg^Vh, Gs, Gs, Dd, Gs^Ft, Gs^Ft, Re
Dd, Dd, Dd, Dd, Hd, Hd, Hd, Dd, Rd, Rd, Gs^Ft, Rd, Dd, Gs^Vht, Hd, Hd, Md, Md, Md, Md, Hd, Hd, Hd, Dd, Dd, Gs^Ft, Gs, Gs, Gs, Dd, Dd^Vda, Dd, Ww, Ww, Ww, Ww, Gs, Gs^Ft, Gs, Gs^Ft, Re, Re
Dd, Dd^Vda, Dd, Dd, Hd, Hd, Rd, Rd, Dd, Dd^Vda, Dd, Rd, Rd, Gs^Ft, Gs, Gs, Hd, Hd, Hd, Md, Hd, Md, Hd, Hd, Gs^Ft, Gs, Gs, Gs, Dd, Ww, Ww, Ww, Ww, Ww, Ww, Ww, Gs^Ft, Gs^Ft, Gs^Ft, Gs^Ft, Rd, Gs
Ww, Gs^Ft, Gs^Ft, Dd, Rd, Rd, Hd, Hd, Hd, Hd, Dd, Dd, Gs^Ft, Re, Re, Gs, Gs^Ft, Dd, Hd, Md, Md, Md, Hd, Hd, Gs, Gs, Gs, Dd, Ww, Ww, Ww, Ww, Ww, Ww, Ww, Ww, Dd, Gs^Ft, Gs, Re, Gs^Ft, Gs^Ft
Gs^Ft, Gs^Ft, Dd, Rd, Hd, Hd, Hd, Hd, Hd, Hd, Dd, Dd, Gs^Ft, Gs, Gs, Re, Re, Dd, Hd, Hd, Hd, Md, Hd, Hd, Gs, Gs, Gs, Gs, Gs^Ft, Ww, Ww, Ww, Ww, Ww, Ww, Ww, Gs^Vht, Gs, Gs, Re, Gs^Ft, Gs^Ft
Gs^Ft, Gs^Ft, Dd, Rd, Hd, Md, Md, Md, Md, Hd, Dd, Dd, Gs^Ft, Gs, Dd, Gs, Re, Gs^Ft, Dd, Hd, Hd, Hd, Md, Hd, Gs, Gs, Gs, Gs^Ft, Gs^Vht, Gs^Ft, Dd, Dd, Ww, Ww, Ww, Ww, Gs^Ft, Gs, Gs, Rd, Gs^Ft, Gs^Ft
Gs^Ft, Gs^Ft, Gs^Ft, Rd, Hd, Md, Md, Md, Hd, Hd, Dd, Dd, Dd, Gs^Ft, Dd, Gs, Gs, Re, Gs^Ft, Hd, Hd, Md, Hd, Hd, Gs, Gs, Gs^Ft, Gs^Ft, Gs^Ft, Gs^Ft, Dd, Dd, Ww, Ww, Ww, Ww, Dd, Gs, Gs^Ft, Rd, Gs^Ft, Hd
Gs^Ft, Gs^Ft, Gs^Ft, Rd, Hd, Md, Md, Md, Hd, Hd, Dd, Dd, Dd, Dd, Gs^Ft, Gs^Ft, Gs^Ft, Re, Re, Hd, Md, Md, Md, Hd, Hd, Gs^Ft, Gs^Ft, Dd, Dd, Gs^Ft, Dd, Dd, Dd, Ww, Ww, Ww, Dd, Gs^Ft, Gs, Rd, Gs^Ft, Hd
Gs^Ft, Gs^Ft, Gs^Ft, Rd, Hd, Hd, Md, Hd, Hd, Dd, Dd, Dd, Dd, Dd, Dd, Dd, Gs^Ft, Gs, Re, Hd, Md, Md, Md, Hd, Hd, Gs^Ft, Gs^Ft, Gs^Ft, Gs^Ft, Gs^Ft, Dd, Dd, Dd, Ww, Ww, Dd, Gs^Ft, Gs^Ft, Gs, Re, Gs^Ft, Dd
Gs^Ft, Dd, Rd, Rd, Hd, Hd, Hd, Hd, Dd, Dd, Dd, Dd, Dd, Dd, Dd, Dd, Dd, Gs^Ft, Re, Hd, Hd, Md, Hd, Hd, Hd, Gs, Gs, Gs^Ft, Gs^Ft, Gs^Ft, Dd, Dd, Dd, Dd, Dd, Dd, Dd, Gs^Ft, Gs^Vht, Re, Dd, Hd
Dd, Dd, Rd, Dd, Dd, Gs^Ft, Gs^Ft, Dd, Dd, Dd, Dd, Dd, Dd^Vda, Ww, Ww, Dd, Dd, Gs^Ft, Re, Dd^Vdt, Hd, Hd, Hd, Dd, Dd, Gs, Gs^Ft, Gs^Ft, Gs^Ft, Dd, Dd, Dd, Dd, Dd, Gs, Dd, Dd, Gs^Ft, Gs^Ft, Re, Gs^Ft, Hd
Dd, Dd^Vda, Rd, Dd, Dd, Dd, Gs^Ft, Gs^Ft, Dd, Dd^Vda, Dd, Ww, Ww, Ww, Ww, Dd, Dd, Gs^Ft, Gs, Rd, Rd, Hd, Rd, Dd, Dd, Gs^Ft, Gs^Ft, Dd, Dd, Dd, Dd, Dd, Dd, Dd, Dd, Dd, Dd, Dd, Gs, Re, Re, Hd
Dd, Rd, Dd, Dd, Dd, Dd, Gs^Ft, Gs^Ft, Dd, Ww, Ww, Ww, Ww, Ww, Ww, Ww, Dd, Gs, Gs, Gs^Ft, Gs^Ft, Rd, Dd, Rd, Rd, Gs^Ft, Dd, Dd, Dd, Dd, Dd, Dd, Dd, Dd, Dd, Dd, Dd, Gs^Ft, Gs, Gs, Re, Gs
Rd, Rd, Dd, Dd, Dd, Dd, Dd, Ww, Ww, Ww, Ww, Wo, Wo, Ww, Ww, Ww, Dd, Gs^Ft, Gs^Ft, Gs, Gs^Ft, Dd, Dd, Dd, Dd, Rd, Rd, Dd, Dd, Dd, Dd, Dd^Vda, Dd, Dd, Dd, Dd, Dd, Dd, Gs, Gs, Re, Gs
Gs^Ft, Gs^Ft, Gs^Ft, Gs^Ft, Gs^Ft, Gs^Ft, Ww, Ww, Ww, Ww, Ww, Ww, Wo, Ww, Ww, Dd, Dd, Gs^Ft, Gs, Gs, Gs, Gs, Gs^Ft, Gs^Ft, Dd, Dd, Dd^Vda, Rd, Rd, Dd, Dd, Dd, Rd, Gs^Ft, Gs^Ft, Dd, Dd, Dd, Gs^Ft, Gs, Re, Gs
Gs, Gs, Gs, Gs, Gs, Gs, Ww, Ww, Ww, Ww, Ww, Ww, Wo, Ww, Ww, Dd, Dd, Hd, Hd, Hd, Hd, Hd, Gs^Ft, Dd, Dd^Vda, Dd, Dd, Dd, Dd, Rd, Rd, Rd, Gs^Ft, Re, Re, Gs^Ft, Dd, Dd, Rd, Rd, Gs^Ft, Gs^Ft
Hd, Hd, Gs, Gs, Gs, Gs, Ww, Ww, Ww, Ww, Ww, Ww, Ww, Ww, Dd, Dd, Dd, Hd, Hd, Hd, Hd, Hd, Dd, Dd, Dd, Dd, Dd, Dd, Dd, Dd, Dd, Gs^Ft, Gs, Dd, Re, Ch, Ch, Ch, Rd, Dd, Dd, Ww
Hd, Hd, Gs, Gs, Gs, Gs, Ww, Ww, Ww, Ww, Ww, Ww, Dd, Dd^Vda, Dd, Gs^Ft, Hd, Md, Md, Hd, Hd, Hd, Hd, Dd, Dd, Dd, Dd, Dd, Gs, Gs, Dd, Dd, Ww, Dd, Dd, Ch, 2 Kh, Ch, Dd, Dd^Vda, Ww, Ww
Hd, Hd, Gs^Ft, Gs, Gs, Gs, Dd, Ww, Ww, Ww, Ww, Dd^Vda, Dd, Dd, Gs^Ft, Hd, Hd, Md, Md, Md, Hd, Hd, Hd, Dd, Dd, Dd, Dd, Gs, Gs, Gs, Gs, Ww, Ww, Dd, Ch, Ch, Ch, Rd, Dd, Ww, Ww, Ww
Gs^Ft, Gs^Ft, Gs^Vht, Gs^Ft, Gs, Gs, Dd, Ww, Ww, Ww, Ww, Dd, Dd, Dd, Hd, Hd, Md, Md, Md, Hd, Hd, Hd, Hd, Dd, Dd, Dd, Dd, Gs, Gs, Gs, Gs, Dd, Dd, Dd, Rd, Rd, Dd, Gs, Dd, Ww, Ww, Ww
Dd, Dd, Dd, Gs^Ft, Gs^Ft, Gs^Ft, Ww, Ww, Ww, Ww, Ww, Dd, Dd, Hd, Hd, Md, Md, Md, Hd, Hd, Hd, Hd, Hd, Hd, Dd, Dd^Vda, Dd, Dd, Gs, Gs, Gs, Dd, Dd^Vda, Dd, Rd, Dd, Dd, Gs, Dd, Dd, Ww, Ww
Dd, Dd, Dd, Dd, Gs^Ft, Dd, Dd, Dd, Dd, Ww, Dd, Dd, Dd, Hd, Md, Md, Md, Md, Hd, Hd, Hd, Md, Hd, Hd, Hd, Dd, Dd, Dd, Dd, Dd, Dd, Dd, Rd, Rd, Hd, Hd, Hd, Gs, Dd, Dd, Gs, Gs^Ft
Dd, Dd, Dd, Dd, Dd, Dd, Dd, Dd, Dd, Dd, Dd, Dd, Dd, Hd, Hd, Hd, Hd, Hd, Hd, Hd, Hd, Md, Hd, Hd, Hd, Dd, Dd, Hd, Hd, Hd, Hd, Hd, Rd, Hd, Hd, Hd, Hd, Hd, Dd, Dd, Gs^Ft, Gs^Ft
