Hd, Hd, Dd, Dd, Dd, Dd, Gs^Ft, Gs, Gs, Gs, Dd, Dd, Dd, Gs, Gs, Gs, Gs, Gs, Gs, Dd, Dd, Dd, Dd, Dd, Dd, Dd, Dd, Dd, Gs, Gs, Gs, Gs, Gs, Gs^Ft, Dd, Dd, Dd, Dd, Dd, Dd, Gs, Gs
Md, Hd, Hd, Dd, Dd, Gs^Ft, Gs, Gs^Ft, Gs^Ft, Gs^Ft, Dd, Dd, Dd, Dd, Gs, Gs, Gs, Gs, Gs^Ft, Dd, Dd, Dd, Dd, Dd, Dd, Dd, Dd, Dd, Dd, Dd, Dd, Dd, Gs, Dd, Hd, Dd, Dd, Dd, Dd, Dd, Gs, Gs
Md, Md, Hd, Dd, Dd, Dd, Gs^Ft, Gs^Vht, Dd, Dd, Dd, Dd, Gs^Ft, Gs, Gs, Gs, Gs, Gs, Gs, Gs^Ft, Dd, Dd, Dd, Dd, Dd, Dd, Dd, Dd, Dd, Gs, Dd, Dd, Dd, Dd, Hd, Hd, Dd, Hd, Hd, Dd, Dd, Dd
Md, Md, Hd, Hd, Dd, Dd, Gs^Ft, Gs^Ft, Dd, Dd, Dd, Dd, Gs^Ft, Gs, Gs, Gs, Gs, Gs, Gs, Dd, Dd, Dd, Dd, Dd, Dd, Dd^Vda, Dd, Dd, Dd, Gs, Dd, Dd, Dd^Vda, Dd, Dd, Ch, Ch, Ch, Dd, Dd, Dd, Dd
Hd, Md, Md, Hd, Dd, Dd, Dd, Dd, Dd, Dd, Dd, Dd, Gs^Ft, Gs, Gs, Gs, Gs, Gs, Gs^Ft, Dd, Dd, Dd, Dd, Dd, Dd, Dd, Dd, Dd, Dd, Dd, Gs, Dd, Dd, Dd, Dd, Ch, 1 Kh, Ch, Dd, Gs^Ft, Dd, Dd
Hd, Md, Md, Hd, Hd, Dd, Dd, Dd, Dd, Ww, Dd, Gs^Ft, Gs^Vht, Hd, Gs, Gs, Gs^Ft, Gs^Ft, Gs^Ft, Dd, Dd, Dd, Dd, Dd, Dd, Dd, Dd, Dd, Dd, Dd, Dd, Dd, Dd, Dd, Ch, Ch, Ch, Hd, Gs, Gs, Gs^Ft, Dd
Hd, Hd, Hd, Hd, Hd, Dd, Dd, Gs^Ft, Ww, Ww, Dd, Gs, Gs^Ft, Gs^Ft, Hd, Gs^Ft, Dd, Dd, Dd, Dd, Dd, Gs^Ft, Dd, Dd, Dd, Hd, Hd, Hd, Hd, Hd, Hd, Hd, Hd, Rd, Hd, Hd, Hd, Hd, Gs, Gs, Dd, Dd
Hd, Hd, Hd, Hd, Dd, Dd, Dd, Dd, Ww, Ww, Gs^Ft, Dd, Dd, Dd, Dd, Dd, Dd, Dd, Dd, Dd, Dd^Vda, Dd, Dd, Dd, Dd, Hd, Hd, Md, Hd, Hd, Hd, Hd, Dd, Rd, Hd, Gs^Ft, Hd, Gs^Ft, Gs, Gs^Ft, Dd, Dd
Gs, Hd, Gs^Vht, Dd, Dd, Dd, Dd, Dd^Vda, Ww, Ww, Dd, Dd, Dd, Dd, Dd, Gs, Dd, Dd, Dd, Dd, Dd, Dd, Hd, Hd, Dd, Hd, Hd, Md, Md, Md, Hd, Hd, Hd, Rd, Gs^Ft, Gs, Gs, Gs, Gs^Ft, Dd, Dd^Vda, Dd
Re, Gs^Ft, Rd, Gs^Ft, Rd, Gs^Ft, Dd, Dd, Dd, Dd, Dd, Dd, Dd, Gs, Gs, Gs, Dd, Dd, Gs, Gs, Hd, Hd, Hd, Hd, Hd, Hd, Md, Md, Md, Md, Hd, Hd, Re, Re, Gs, Gs, Gs, Gs^Ft, Dd, Dd, Dd, Dd
Dd, Rd, Dd, Rd, Gs^Ft, Rd, Rd, Dd, Dd, Dd, Dd, Dd, Dd, Gs, Gs, Gs, Dd, Dd, Gs, Gs^Ft, Hd, Hd, Hd, Gs, Hd, Hd, Md, Md, Md, Md, Hd, Hd, Re, Gg^Vh, Gs, Gs, Gs^Ft, Dd, Dd, Dd, Dd, Gs
Dd, Dd, Gs^Ft, Gs^Ft, Gs^Ft, Dd, Dd, Rd, Dd, Dd, Dd, Dd, Dd, Dd, Re, Rd, Rd, Dd, Gs, Dd, Hd, Dd, Gs, Dd, Dd, Dd^Vdt, Hd, Md, Md, Md, Md, Hd, Re, Gs, Gs, Gs, Dd, Dd, Dd, Dd, Dd, Gs
Dd, Dd, Gs^Ft, Gs, Gs^Ft, Dd, Dd, Rd, Rd, Gs^Ft, Ww, Dd, Rd, Rd, Dd^Vda, Ww, Rd, Gs^Ft, Gs, Gs^Ft, Dd, Dd, Dd, Dd, Dd, Hd, Md, Md, Md, Md, Md, Hd, Re, Gs, Gs, Gs, Gs^Ft, Dd, Ww, Dd, Dd, Gs
Gs^Ft, Gs^Ft, Gs^Vht, Gs^Ft, Dd, Dd, Dd, Dd, Dd, Rd, Rd, Rd, Gs^Ft, Dd, Ww, Ww, Gs^Ft, Re, Gs, Gs^Ft, Dd, Dd^Vda, Dd, Dd, Dd, Hd, Hd, Md, Md, Md, Md, Hd, Re, Gs, Gs, Gs, Gs^Ft, Gs^Vht, Dd, Dd, Dd, Dd
Gs, Gs^Ft, Gs^Ft, Dd, Dd, Dd, Dd, Dd, Dd, Dd^Vda, Ww, Ww, Ww, Ww, Dd, Dd, Gs^Ft, Re, Re, Re, Rd, Dd, Dd, Dd, Dd, Dd, Hd, Md, Md, Md, Md, Hd, Re, Gs, Gs^Ft, Dd, Dd, Gs^Ft, Gs^Ft, Dd, Dd, Dd
Gs, Gs, Dd, Dd, Dd, Dd, Dd, Dd, Dd, Ww, Ww, Ww, Ww, Ww, Dd, Dd, Gs^Ft, Gs, Gs, Gs, Gs, Re, Rd, Dd, Dd, Dd, Hd, Md, Md, Md, Md, Hd, Re, Gs^Ft, Dd, Dd, Dd, Gs, Gs, Gs^Ft, Gs, Gs^Ft
Gs, Gs, Gs^Ft, Dd, Dd, Dd, Gs^Ft, Gs^Ft, Dd, Ww, Ww, Ww, Ww, Dd, Dd, Dd, Gs^Ft, Gs, Gs, Ww, Ww, Ww, Dd, Rd, Rd, Dd, Hd, Hd, Md, Md, Hd, Hd, Re, Gs^Ft, Dd, Dd, Gs^Ft, Gs, Gs, Gs, Gs, Gs
Gs, Gs, Gs, Dd, Gs^Ft, Gs, Gs, Gs^Ft, Dd, Ww, Ww, Ww, Dd, Dd, Dd, Dd, Gs^Ft, Gs, Dd, Gs^Ft, Dd, Gs, Ww, Ww, Dd, Rd, Dd, Hd, Hd, Hd, Hd, Gs, Re, Gs^Ft, Dd, Dd, Gs^Ft, Gs, Gs, Gs, Gs, Dd
Gs^Ft, Gs, Gs^Ft, Dd, Dd, Gs, Gs, Gs^Ft, Ww, Ww, Ww, Dd, Dd, Dd, Dd, Dd, Gs^Ft, Gs, Dd, Dd, Gs^Ft, Ww, Ww, Ww, Dd, Rd, Hd, Hd, Hd, Hd, Gs, Gs, Re, Gs, Hd, Gs, Gs, Gs, Gs, Gs, Gs, Dd
Dd, Gs, Gs, Gs, Gs^Ft, Gs^Ft, Gs^Ft, Dd, Ww, Ww, Ww, Dd, Dd, Dd^Vda, Dd, Dd, Gs^Ft, Gs, Gs, Ww, Ww, Ww, Ww, Dd, Dd, Rd, Dd, Hd, Hd, Gs, Re, Re, Re, Gg^Vh, Gs, Gs, Gs, Gs, Gs, Gs, Dd, Dd
Gs, Gs, Gs, Gs, Gs^Ft, Dd, Gs^Ft, Ww, Ww, Ww, Ww, Dd, Dd, Dd, Dd, Dd, Dd, Gs^Ft, Dd, Ww, Ww, Ww, Gg^Vh, Gs, Gs^Ft, Re, Gs, Gs, Hd, Re, Gs, Gs, Gs, Re, Re, Gs, Gs, Gs, Gs, Gs, Dd, Dd
Gs, Gs, Gs, Gs, Gs^Ft, Dd, Dd, Ww, Ww, Ww, Ww, Dd, Dd, Dd, Dd, Dd, Dd, Dd, Dd, Ww, Ww, Dd, Gs^Ft, Gs, Rd, Re, Re, Re, Re, Re, Gs, Gs, Gs, Gs^Ft, Gs^Ft, Rd, Gs^Ft, Gs, Gs, Dd, Dd, Dd
Gs^Ft, Gs^Ft, Gs^Ft, Gs, Gs^Vht, Gs, Dd, Ww, Ww, Ww, Ww, Dd, Dd, Dd, Gs, Gs, Dd, Dd, Dd, Dd, Dd, Gs, Re, Rd, Gs^Ft, Gg^Vh, Gs, Gs, Gs, Gs^Ft, Gs^Ft, Gs, Gs, Gs^Vht, Gs^Ft, Rd, Dd, Dd, Dd, Dd, Dd, Dd
Dd, Dd, Dd, Gs^Ft, Gs^Ft, Gs^Ft, Dd, Ww, Ww, Ww, Ww, Dd^Vda, Dd, Gs, Gs, Gs, Gs, Dd, Rd, Gs^Ft, Rd, Rd, Dd, Dd, Gs, Gs, Gs, Gs, Gs^Ft, Gs^Ft, Dd, Dd, Hd, Hd, Dd, Rd, Dd, Dd, Dd, Dd, Dd, Dd
Hd, Hd, Hd, Hd, Dd, Gs^Ft, Gs, Dd, Ww, Ww, Ww, Ww, Dd, Gs, Gs, Gs, Re, Rd, Dd, Rd, Dd, Dd, Dd, Dd, Dd, Gs^Ft, Dd, Dd, Dd, Dd, Hd, Hd, Hd, Hd, Hd, Rd, Dd, Dd, Dd, Dd, Dd, Dd
Md, Md, Hd, Hd, Dd, Dd, Gs, Gs, Ww, Ww, Ww, Dd, Dd, Gs, Gs, Dd, Rd, Hd, Dd, Hd, Hd, Hd, Dd^Vda, Dd, Dd, Dd, Dd^Vda, Dd, Dd, Dd, Hd, Hd, Hd, Hd, Hd, Rd, Dd, Dd, Dd, Dd, Dd, Dd
Md, Md, Md, Hd, Dd, Gs^Ft, Gs, Gs, Gs^Ft, Ww, Dd, Dd, Dd, Gs, Re, Re, Dd, Hd, Hd, Hd, Hd, Hd, Dd, Dd, Dd, Dd, Dd, Dd, Dd, Dd, Hd, Hd, Md, Hd, Dd, Rd, Dd, Dd, Dd^Vda, Dd, Dd, Dd
Md, Md, Md, Hd, Hd, Gs^Ft, Gs, Gs, Dd, Dd, Dd^Vda, Dd, Rd, Dd^Vda, Re, Gs, Dd, Hd, Hd, Hd, Hd, Hd, Hd, Dd, Dd, Dd, Dd, Dd, Dd, Dd, Hd, Hd, Hd, Hd, Dd, Rd, Rd, Dd, Dd, Dd, Dd, Dd
Hd, Hd, Md, Hd, Hd, Gs, Gs, Dd, Gs^Ft, Dd, Rd, Rd, Dd, Re, Gs, Dd, Hd, Hd, Hd, Hd, Hd, Hd, Hd, Hd, Dd, Dd, Dd, Dd, Dd, Hd, Hd, Hd, Hd, Dd, Dd, Dd, Dd, Rd, Dd, Dd, Dd, Dd
Hd, Hd, Hd, Hd, Hd, Gs, Gs^Ft, Gs, Re, Rd, Dd, Dd, Dd, Dd, Dd, Dd, Hd, Hd, Hd, Hd, Hd, Gs^Ft, Gs, Gs, Gs^Ft, Dd, Dd, Dd, Dd, Hd, Hd, Gs, Gs^Ft, Dd, Dd, Dd, Ww, Rd, Rd, Rd, Rd, Dd
Gs, Hd, Hd, Gg^Vh, Gs, Gs, Gs, Re, Gs, Gs^Ft, Dd, Dd, Dd, Dd, Dd, Dd, Dd, Hd, Dd, Dd, Dd, Gs, Gs, Gs, Gs^Ft, Dd, Dd, Gs^Ft, Gs^Ft, Hd, Hd, Gs, Gs^Ft, Dd, Dd, Dd, Ww, Ww, Ww, Ww, Rd, Dd
Gs, Gs, Gs, Gs, Gs, Gs, Re, Re, Gs^Ft, Dd, Dd, Dd, Dd, Dd, Gs, Gs, Gs^Ft, Dd, Dd, Dd, Dd, Gs, Gs, Gs, Gs, Gs, Gs, Gs, Hd, Hd, Gs, Gs, Gs, Gs^Ft, Gs^Ft, Dd^Vda, Dd, Ww, Ww, Ww, Ww, Ww
Gs, Gs, Gs, Gs, Gs, Re, Gs^Ft, Dd, Gs^Ft, Dd, Dd, Gs^Ft, Gs^Ft, Gs, Gs, Gs, Dd, Dd, Dd, Dd, Dd, Gs^Ft, Gg^Vh, Gs^Ft, Gs^Ft, Gs^Ft, Gs^Ft, Hd, Hd, Hd, Gg^Vh, Gs, Gs, Gs, Gs, Gs^Ft, Dd, Dd, Ww, Ww, Ww, Ww
Gs^Ft, Gs, Gs, Dd, Dd, Rd, Dd, Dd, Gs^Ft, Gs^Ft, Gs^Ft, Dd, Dd, Dd, Gs, Gs^Ft, Dd, Dd, Dd, Dd, Dd, Ww, Gs^Ft, Gs^Ft, Gs^Ft, Dd, Hd, Hd, Hd, Hd, Gs, Gs, Gs, Gs, Gs, Gs^Ft, Gs^Ft, Dd, Ww, Ww, Ww, Ww
Gs^Ft, Gs^Vht, Gs^Ft, Dd, Dd, Rd, Dd, Gs^Ft, Gs, Ww, Gs^Ft, Dd, Dd, Dd, Dd, Dd, Dd, Ww, Ww, Dd, Dd, Dd, Gs^Ft, Gs^Ft, Gs^Ft, Gs^Ft, Hd, Hd, Hd, Hd, Hd, Gs^Ft, Gs^Ft, Gs, Gs, Gs, Gs^Ft, Dd, Dd, Ww, Ww, Ww
Dd, Dd, Dd, Ch, Ch, Ch, Dd, Dd, Ww, Ww, Ww, Ww, Ww, Dd, Dd, Dd, Gs^Ft, Gg^Vh, Dd, Dd, Dd, Dd, Gs^Ft, Dd, Dd, Dd, Dd, Hd, Hd, Hd, Hd, Dd, Dd, Gs^Ft, Gs, Gs, Gs, Gs^Ft, Dd, Ww, Ww, Ww
Dd, Dd, Dd, Ch, 2 Kh, Ch, Dd, Gs^Ft, Gg^Vh, Ww, Dd, Dd, Dd, Dd, Dd, Dd, Gs, Gs, Gs, Gs^Ft, Ww, Dd, Dd, Dd, Dd, Dd, Dd, Hd, Hd, Hd, Hd, Hd, Dd, Gs^Ft, Gs, Gs, Gs, Gs, Dd, Ww, Ww, Ww
Dd, Gs, Ch, Ch, Ch, Dd, Dd, Dd, Gs, Gs, Dd, Dd, Dd, Dd, Dd, Dd, Gs, Gs, Gs, Gs^Ft, Dd, Dd, Dd, Dd, Dd, Dd, Dd, Hd, Hd, Hd, Hd, Hd, Dd, Dd, Gs, Gs, Gg^Vh, Gs, Ww, Ww, Ww, Ww
Dd, Gs, Gs, Gs, Dd, Dd, Gs^Ft, Gs^Ft, Gs^Ft, Gs^Ft, Dd, Dd, Dd, Dd, Hd, Hd, Gs^Ft, Gs, Gs, Gs, Gs^Ft, Gs^Ft, Dd, Dd, Dd, Dd, Dd^Vda, Dd, Hd, Hd, Hd, Hd, Hd, Dd, Gs, Gs, Ww, Ww, Ww, Ww, Ww, Rd
Dd, Gs, Gs, Gs, Hd, Hd, Hd, Hd, Hd, Dd, Dd, Dd, Dd^Vda, Hd, Hd, Hd, Hd, Gs^Ft, Gs, Gs, Gs, Gs, Gs^Ft, Dd, Dd, Dd, Dd, Dd, Hd, Hd, Hd, Hd, Hd, Dd, Gs, Gs, Ww, Ww, Ww, Ww, Dd, Gs^Ft
Dd, Dd, Dd, Dd, Hd, Md, Md, Hd, Md, Hd, Dd, Dd, Hd, Hd, Hd, Hd, Hd, Hd, Gs^Ft, Gs, Gs, Gs, Gs^Ft, Dd, Dd, Dd, Dd, Dd, Hd, Hd, Md, Hd, Hd, Gs, Gs, Gs, Ww, Ww, Ww, Ww, Dd, Dd
Dd, Dd, Rd, Hd, Hd, Hd, Hd, Md, Hd, Hd, Hd, Dd, Hd, Hd, Hd, Hd, Hd, Hd, Hd, Dd, Gs^Ft, Gs, Gs, Dd, Dd, Dd, Dd, Dd, Gs, Hd, Hd, Hd, Gs, Gs, Gs, Gs, Gs^Ft, Ww, Ww, Ww, Dd, Rd
