Dd, Gs, Gs, Gs, Gs, Gs, Gs^Ft, Ww, Ww, Ww, Ww, Gs^Ft, Gs^Ft, Gs, Gs, Dd, Dd, Dd, Dd, Ww, Dd, Dd, Dd, Dd, Dd, Dd, Hd, Dd, Dd, Hd, Md, Md, Md, Md, Md, Md, Md, Md, Md, Md, Hd, Dd
Gs^Ft, Gs, Gs, Gs, Gs, Gs, Gs^Vht, Ww, Ww, Wo, Ww, Ww, Ww, Dd, Dd^Vda, Dd, Ww, Dd, Gs, Gs, Gs^Ft, Gs^Ft, Dd, Dd, Hd, Hd, Hd, Hd, Hd, Hd, Hd, Hd, Hd, Md, Md, Md, Md, Md, Md, Md, Hd, Dd
Gs^Ft, Gs^Ft, Gs, Gs, Gs, Gs, Gs^Ft, Ww, Ww, Ww, Ww, Ww, Ww, Ww, Ww, Ww, Ww, Gs, Gs, Gs, Gg^Vh, Hd, Hd, Hd, Hd, Hd, Hd, Hd, Hd, Md, Hd, Hd, Hd, Dd, Hd, Hd, Hd, Hd, Hd, Hd, Hd, Hd
Dd, Dd, Dd, Ch, Ch, Ch, Ww, Ww, Ww, Ww, Ww, Ww, Ww, Ww, Ww, Ww, Dd, Gs, Gs, Hd, Hd, Hd, Md, Hd, Hd, Hd, Hd, Md, Md, Md, Hd, Dd, Dd, Dd, Dd, Dd, Hd, Hd, Hd, Hd, Md, Hd
Dd, Dd^Vda, Dd, Ch, 2 Kh, Ch, Ww, Ww, Ww, Ww, Ww, Ww, Ww, Ww, Ww, Ww, Gs, Gs, Gs, Hd, Hd, Hd, Hd, Hd, Hd, Hd, Hd, Hd, Hd, Hd, Dd, Dd, Dd, Dd, Dd, Dd, Hd, Hd, Hd, Hd, Hd, Hd
Dd, Dd, Ch, Ch, Ch, Rd, Dd, Ww, Ww, Ww, Ww, Dd, Dd, Gs^Ft, Gs, Gs, Gs, Gs, Hd, Hd, Md, Hd, Hd, Hd, Hd, Hd, Hd, Hd, Gs, Dd, Dd^Vda, Dd, Dd^Vda, Ww, Gs^Ft, Dd, Dd, Dd^Vda, Hd, Hd, Hd, Hd
Dd, Dd, Dd, Dd, Dd, Rd, Rd, Ww, Ww, Ww, Rd, Dd, Dd, Gs^Ft, Rd, Gs^Ft, Gs^Ft, Gs^Ft, Hd, Hd, Hd, Hd, Hd, Hd, Hd, Gs^Ft, Gs^Ft, Gs, Gs, Dd, Dd, Dd, Ww, Dd, Gs, Gs^Ft, Gs, Gs^Ft, Hd, Hd, Hd, Hd
Dd, Dd, Dd, Dd, Dd, Dd, Dd, Rd, Ch, Rd, Ww, Rd, Rd, Rd, Dd, Rd, Rd, Dd, Dd, Dd, Dd, Gs^Ft, Gs^Ft, Dd, Dd, Dd, Dd, Gs^Ft, Gs^Ft, Dd, Dd, Dd, Dd, Gs^Ft, Gs, Gs, Gs, Dd, Hd, Hd, Dd, Dd
Dd, Dd, Dd, Dd, Dd, Dd, Ww, Ww, Dd, Dd, Ww, Dd, Dd, Dd^Vda, Dd, Dd, Dd, Rd, Rd, Dd, Dd, Gs^Ft, Rd, Dd, Dd, Dd, Dd, Dd, Dd, Dd, Dd, Dd, Gs^Ft, Gs, Gs, Gs, Hd, Hd, Hd, Hd, Dd, Dd
Dd, Dd, Dd, Dd, Dd, Dd, Ww, Dd, Dd, Dd^Vda, Dd, Gs, Dd, Dd, Dd, Hd, Hd, Dd, Hd, Rd, Rd, Rd, Dd, Rd, Dd, Dd, Dd, Dd, Dd, Dd, Dd, Dd, Gs^Ft, Gs, Gs, Gs, Hd, Md, Hd, Hd, Hd, Dd
Gs, Gs, Dd, Dd, Ww, Ww, Dd, Dd, Dd, Dd, Dd, Gs, Dd, Dd, Dd, Hd, Gs^Ft, Hd, Hd, Hd, Hd, Gs^Ft, Dd^Vda, Rd, Gs^Ft, Gs^Ft, Gs^Ft, Gs^Ft, Gs^Ft, Dd, Dd, Dd, Dd, Gs^Ft, Gs^Ft, Hd, Md, Md, Md, Hd, Dd, Dd
Gs, Gs, Gg^Vh, Dd, Ww, Dd, Dd, Dd, Dd, Dd, Dd, Dd, Dd, Dd, Dd, Hd, Hd, Hd, Hd, Hd, Hd, Hd, Dd, Rd, Rd, Gs^Ft, Gs^Ft, Gs, Gs, Dd, Dd, Dd, Dd, Dd, Hd, Md, Md, Md, Md, Md, Hd, Dd
Ww, Ww, Ww, Ww, Dd, Dd, Dd, Dd, Dd, Dd, Dd, Dd, Dd, Dd, Dd, Dd, Hd, Hd, Md, Md, Md, Hd, Hd, Dd, Gs^Ft, Re, Gg^Vh, Gs, Gs, Gs^Ft, Gs^Ft, Gs^Ft, Dd, Dd^Vda, Hd, Md, Md, Md, Md, Md, Hd, Dd
Ww, Ww, Ww, Dd, Dd, Dd, Dd, Dd, Dd, Dd, Dd, Dd, Dd, Dd, Dd, Dd, Hd, Md, Md, Md, Md, Md, Hd, Hd, Gs, Re, Gs, Gs, Gs, Gs, Hd, Hd, Hd, Hd, Hd, Md, Md, Md, Md, Md, Hd, Hd
Ww, Hd, Dd, Dd, Dd, Dd, Dd, Hd, Dd^Vdt, Hd, Dd, Dd, Dd, Dd, Dd, Dd, Hd, Md, Md, Md, Md, Md, Hd, Hd, Hd, Re, Gs, Gs, Gs, Dd, Hd, Hd, Md, Md, Md, Md, Md, Md, Md, Md, Md, Md
Ww, Hd, Dd, Dd, Dd, Hd, Hd, Hd, Md, Hd, Hd, Dd, Dd, Gs^Ft, Dd, Dd, Dd, Md, Md, Md, Md, Md, Hd, Hd, Hd, Rd, Gs, Gs, Gs, Gs, Hd, Md, Md, Md, Md, Md, Md, Md, Md, Md, Md, Md
Ww, Hd, Dd, Dd, Dd, Hd, Md, Md, Md, Md, Hd, Gs^Ft, Gs^Ft, Gs^Ft, Gs^Ft, Gs^Ft, Gs, Hd, Md, Md, Hd, Hd, Hd, Hd, Gs, Re, Gs, Gs, Gs, Gs, Hd, Md, Md, Md, Md, Md, Md, Md, Md, Md, Md, Md
Md, Hd, Dd, Dd, Dd, Hd, Md, Md, Md, Md, Md, Hd, Gs, Dd, Gg^Vh, Gs, Gs, Hd, Hd, Hd, Hd, Dd, Dd, Gs^Ft, Gg^Vh, Re, Gs, Gs, Gs, Gs, Hd, Hd, Hd, Md, Hd, Gs, Hd, Hd, Hd, Hd, Md, Md
Hd, Hd, Dd, Dd, Hd, Hd, Md, Md, Md, Md, Md, Hd, Dd, Ww, Ww, Gs, Gs, Hd, Hd, Hd, Hd, Dd, Gs^Ft, Gs, Gs, Rd, Dd, Dd, Gs^Ft, Dd, Dd, Dd, Hd, Hd, Gs, Gs, Gs, Gs, Gg^Vh, Hd, Hd, Md
Hd, Hd, Dd, Dd^Vda, Hd, Md, Md, Md, Md, Md, Md, Hd, Dd, Dd, Ww, Gs, Gs, Hd, Hd, Hd, Hd, Gs^Ft, Gs^Vht, Gs^Ft, Gs, Re, Re, Gs^Ft, Dd, Dd, Dd, Dd, Gs^Ft, Gs, Gs, Gs, Gs, Gs, Gs, Gs, Hd, Hd
Hd, Hd, Hd, Hd, Hd, Md, Md, Md, Md, Md, Md, Gs^Ft, Gs^Ft, Dd, Dd, Gs^Ft, Hd, Hd, Hd, Md, Hd, Hd, Gs^Ft, Gs^Ft, Gs^Ft, Gs, Gs^Ft, Rd, Dd, Dd, Dd, Dd^Vda, Dd, Gs, Gs, Gs, Gs, Gs, Gs, Gs, Gs^Ft, Dd
Hd, Hd, Hd, Gs^Ft, Gs^Ft, Hd, Md, Md, Md, Md, Dd, Gs, Gg^Vh, Ww, Gs^Ft, Gs^Ft, Hd, Md, Md, Md, Md, Md, Hd, Gs^Ft, Gs^Ft, Gs^Ft, Dd, Rd, Dd, Dd, Dd, Dd, Dd, Gs, Gs, Gs, Gs, Gs, Gs^Ft, Gs^Ft, Dd, Dd
Hd, Hd, Gs^Ft, Gs, Gs^Ft, Hd, Hd, Hd, Hd, Hd, Gs^Ft, Gs, Gs, Gg^Vh, Gs^Ft, Hd, Hd, Md, Md, Md, Md, Md, Hd, Gs^Ft, Gs, Gs^Ft, Dd, Rd, Dd, Dd, Dd, Dd, Dd, Gs, Gs^Ft, Gs^Ft, Gs^Ft, Dd, Dd, Dd, Dd, Dd
Md, Hd, Gs, Gs, Gs, Dd, Dd, Dd, Dd, Dd, Dd, Gs, Gs, Gs, Dd, Hd, Hd, Md, Md, Md, Md, Md, Hd, Gs^Ft, Gs^Ft, Dd, Dd, Rd, Rd, Dd, Dd, Dd, Dd, Gs, Gs^Ft, Dd, Dd, Dd, Dd, Dd, Dd, Dd
Hd, Hd, Gs, Gs, Gs, Dd, Dd, Dd, Dd, Dd, Gs, Gs, Gs, Gs^Ft, Gs^Ft, Hd, Md, Md, Md, Md, Md, Md, Md, Hd, Dd, Dd, Dd, Dd, Dd, Rd, Dd, Dd, Gs^Ft, Gs^Ft, Hd, Hd, Hd, Hd, Hd, Dd, Dd, Dd
Gs^Ft, Gs, Gs, Gs, Gs, Dd, Dd, Dd, Dd, Dd, Gs^Ft, Gs^Ft, Gs^Ft, Dd, Gs^Ft, Hd, Md, Md, Md, Md, Md, Md, Hd, Hd, Dd, Dd, Dd, Dd, Gs^Ft, Rd, Dd, Dd, Dd, Hd, Md, Md, Md, Md, Md, Hd, Dd, Dd
Dd, Gs^Ft, Gs, Gs, Gg^Vh, Ww, Ww, Ww, Dd, Dd, Gs^Ft, Dd, Gs^Ft, Dd, Gs^Ft, Hd, Md, Md, Md, Md, Md, Md, Hd, Hd, Dd, Dd, Dd, Dd, Dd, Rd, Rd, Dd^Vda, Dd, Hd, Md, Md, Md, Md, Md, Md, Hd, Dd
Dd, Dd, Gs^Ft, Gs, Ww, Ww, Ww, Ww, Dd, Dd, Dd, Gs^Ft, Dd, Gs^Ft, Dd, Hd, Hd, Md, Md, Md, Md, Hd, Dd, Dd, Dd, Dd, Dd, Dd, Dd, Dd, Dd, Rd, Dd, Hd, Md, Md, Md, Md, Md, Md, Hd, Dd
Gs, Gs^Ft, Dd, Dd, Dd, Ww, Ww, Ww, Dd, Dd, Dd, Dd, Gs^Ft, Gs^Ft, Gs^Vht, Gs^Ft, Gs, Hd, Hd, Hd, Hd, Hd, Dd, Dd^Vda, Dd, Dd, Dd^Vda, Dd, Dd, Dd, Gs, Re, Re, Hd, Md, Md, Md, Md, Md, Md, Md, Rd
Gs, Gs, Ww, Dd, Dd, Dd, Ww, Dd, Dd, Dd, Dd, Dd, Dd, Dd, Gs^Ft, Gs^Ft, Gs, Hd, Hd, Hd, Hd, Dd, Dd, Dd, Dd, Dd, Dd, Ww, Dd, Dd, Gs, Gs, Re, Hd, Hd, Md, Md, Md, Md, Md, Rd, Rd
Ww, Ww, Ww, Ww, Dd, Dd, Dd, Dd, Dd, Dd, Dd, Dd, Dd, Dd, Dd, Dd, Gs^Ft, Hd, Hd, Hd, Hd, Hd, Dd, Dd, Dd, Dd, Dd, Ww, Ww, Ww, Dd, Gs, Re, Dd, Hd, Hd, Hd, Hd, Hd, Rd, Hd, Hd
Dd, Dd, Dd, Dd, Dd, Dd, Dd^Vda, Ww, Ww, Dd, Dd, Dd, Dd, Dd, Dd, Dd, Dd, Dd, Hd, Hd, Hd, Hd, Hd, Hd, Dd, Dd, Dd, Ww, Ww, Ww, Ww, Ww, Rd, Dd, Dd, Dd, Dd, Dd, Rd, Re, Dd, Hd
Dd, Dd, Gs, Dd, Dd, Ww, Ww, Ww, Ww, Dd, Dd, Dd, Dd, Gs^Ft, Gs^Ft, Dd, Dd, Dd, Dd, Hd, Hd, Hd, Hd, Hd, Dd^Vda, Dd, Dd, Dd^Vda, Ww, Ww, Ww, Wo, Ww, Rd, Dd, Dd, Dd, Gs, Re, Gs, Dd, Hd
Dd, Gs, Gs, Gs, Dd, Ww, Ww, Ww, Ww, Dd, Dd, Dd, Dd, Gs^Ft, Dd, Dd, Dd, Dd, Dd, Dd, Hd, Hd, Hd, Hd, Hd, Dd, Dd, Dd, Ww, Ww, Ww, Ww, Ww, Rd, Rd, Dd, Dd, Gs, Re, Gs, Dd, Dd
Gs, Gs, Gs, Dd, Dd^Vda, Ww, Ww, Ww, Dd^Vda, Dd, Dd, Dd, Dd, Gs^Ft, Dd, Dd, Dd, Dd, Dd, Dd, Hd, Hd, Hd, Hd, Hd, Dd, Dd, Dd, Dd, Ww, Ww, Ww, Ww, Dd, Gs^Ft, Ch, Ch, Ch, Re, Dd, Dd, Dd
Gs, Gs, Gs, Dd, Dd, Ww, Ww, Ww, Dd, Dd, Dd, Dd, Dd, Dd, Dd^Vda, Dd, Dd, Dd, Dd, Dd, Gs, Hd, Hd, Hd, Dd, Dd, Rd, Dd, Dd, Dd, Dd, Dd, Gg^Vh, Dd, Rd, Ch, 1 Kh, Ch, Dd, Dd^Vda, Dd, Hd
Dd, Dd, Dd, Dd, Gs^Ft, Ww, Ww, Ww, Dd, Dd, Dd, Dd, Dd, Dd, Dd, Dd, Dd, Dd, Dd, Dd, Gs, Gs, Gs^Ft, Dd, Rd, Rd, Dd, Rd, Rd, Dd, Dd, Dd, Re, Re, Ch, Ch, Ch, Dd, Dd, Dd, Hd, Hd
Dd, Dd, Dd, Dd, Gg^Vh, Ww, Ww, Ww, Dd, Dd, Dd, Dd, Dd, Gs^Ft, Dd, Dd, Dd, Dd, Dd, Gs^Ft, Gs, Gs, Re, Rd, Dd, Dd, Dd, Dd, Dd, Rd, Rd, Rd, Gs, Gs, Gs, Gs^Ft, Dd, Dd, Dd, Hd, Hd, Hd
Gs^Ft, Gs^Ft, Gs^Ft, Dd, Ww, Ww, Ww, Ww, Dd, Dd, Dd, Dd, Gs^Ft, Gs, Gs^Ft, Dd, Dd, Dd, Dd, Gs^Ft, Re, Re, Gs, Gs^Ft, Dd, Dd, Dd, Dd, Gs^Ft, Gs^Ft, Gs, Gs, Gs, Gs, Hd, Gs^Ft, Hd, Dd^Vda, Hd, Hd, Hd, Md
Rd, Gs, Gs, Gs^Ft, Ww, Ww, Ww, Ww, Dd, Dd, Dd, Dd, Gs, Gs, Dd, Dd, Dd, Dd, Dd, Dd, Rd, Dd, Dd, Gs^Ft, Gs^Ft, Dd, Dd, Gs^Ft, Gs^Ft, Gs, Gs, Hd, Gs, Hd, Hd, Md, Hd, Hd, Hd, Hd, Md, Md
Re, Gs, Gs, Gs^Ft, Dd, Dd, Ww, Ww, Ww, Dd, Dd, Gs^Ft, Gs^Ft, Dd, Dd, Dd, Dd, Dd, Re, Rd, Dd, Dd, Dd, Gs^Vht, Gs^Ft, Gs^Ft, Dd, Gs, Gs, Gs, Gs, Hd, Hd, Hd, Md, Hd, Md, Md, Hd, Hd, Md, Md
Re, Hd, Gs^Ft, Gs^Ft, Dd, Dd, Dd, Ww, Ww, Ww, Dd, Dd, Dd, Dd, Dd, Hd, Gs, Gs, Re, Gs, Dd, Dd, Dd, Gs^Ft, Gs^Ft, Gs^Ft, Gs, Gs^Ft, Hd, Hd, Gs, Gs, Gs, Gs, Hd, Hd, Md, Md, Hd, Hd, Hd, Md
