Rd, Dd, Dd, Hd, Hd, Dd, Dd, Dd, Dd, Gs, Gs, Gs^Ft, Dd, Hd, Hd, Md, Md, Md, Md, Md, Hd, Hd, Hd, Gs, Gs, Re, Hd, Hd, Hd, Hd, Hd, Hd, Dd, Dd, Hd, Hd, Gs^Ft, Hd, Hd, Hd, Hd, Gs
Rd, Dd, Dd, Hd, Hd, Hd, Dd, Dd, Dd, Gs, Gg^Vh, Gs^Ft, Hd, Hd, Md, Md, Md, Md, Md, Md, Md, Hd, Hd, Gs, Gs^Ft, Rd, Rd, Dd, Gs^Ft, Gs, Hd, Hd, Hd, Gs^Ft, Dd, Dd, Dd, Dd, Gs^Ft, Gs, Gs, Hd
Rd, Dd, Dd, Dd, Hd, Dd, Hd, Dd, Gs^Ft, Gs, Gs, Gs, Hd, Hd, Md, Md, Md, Md, Md, Md, Md, Md, Hd, Hd, Dd, Dd, Rd, Gs^Ft, Gs, Gs, Hd, Hd, Md, Hd, Dd, Dd^Vda, Dd, Dd, Dd, Gs^Ft, Hd, Hd
Dd, Rd, Dd, Dd, Dd, Dd, Gs^Ft, Hd, Hd, Hd, Hd, Hd, Hd, Md, Md, Md, Md, Md, Md, Md, Md, Md, Md, Md, Dd, Dd, Dd, Rd, Re, Gs, Hd, Hd, Md, Hd, Hd, Ch, Ch, Ch, Dd, Hd, Hd, Md
Dd, Rd, Ww, Ww, Ww, Gs^Ft, Hd, Hd, Md, Md, Md, Md, Hd, Md, Md, Md, Md, Md, Md, Md, Ww, Ww, Ww, Ww, Dd^Vdt, Dd, Gs^Ft, Gs^Ft, Rd, Gs, Hd, Hd, Md, Md, Hd, Ch, 1 Kh, Ch, Gs^Ft, Hd, Md, Md
Dd, Re, Ww, Ww, Ww, Hd, Hd, Md, Md, Md, Md, Md, Md, Hd, Md, Hd, Md, Md, Md, Md, Ww, Ww, Ww, Ww, Ww, Gs^Ft, Rd, Re, Gs^Ft, Gs^Ft, Hd, Hd, Md, Md, Ch, Ch, Ch, Gs^Ft, Hd, Hd, Hd, Md
Ww, Ww^Bw|, Gs, Gg^Vh, Ww, Hd, Md, Md, Md, Md, Md, Md, Md, Md, Hd, Hd, Md, Md, Md, Md, Ww, Ww, Ww, Ww, Ww, Ww, Re, Gs, Gs, Gs^Ft, Hd, Md, Md, Md, Md, Hd, Re, Gs, Hd, Hd, Hd, Hd
Gs, Re, Re, Gs^Ft, Ww, Hd, Md, Md, Md, Md, Md, Md, Hd, Hd, Hd, Hd, Hd, Hd, Md, Md, Md, Md, Md, Hd, Hd, Ch, Ww, Gg^Vh, Gs, Gs^Ft, Hd, Hd, Md, Md, Hd, Hd, Re, Gs, Gs, Hd, Hd, Dd
Gs, Gs, Gs, Rd, Ww^Bw\, Hd, Rd, Md, Md, Md, Md, Md, Hd, Dd, Dd, Dd, Gs, Hd, Hd, Md, Hd, Md, Hd, Hd, Hd, Rd, Ww, Ww, Hd, Hd, Hd, Md, Md, Hd, Hd, Dd^Vdt, Re, Gs, Gs, Gs^Ft, Dd, Dd
Gs, Gs^Ft, Dd, Dd, Ww, Rd, Hd, Rd, Rd, Md, Md, Hd, Hd, Dd, Dd, Dd, Dd, Dd, Hd, Hd, Hd, Hd, Hd, Hd, Rd, Rd, Gs^Ft, Ww, Hd, Hd, Hd, Hd, Hd, Hd, Gs^Ft, Gs, Re, Gs, Gs, Gs^Ft, Dd, Dd
Gs^Ft, Dd, Dd, Dd^Vda, Ww, Hd, Hd, Md, Md, Rd, Rd, Dd^Vdt, Rd, Gs, Gs, Dd, Dd^Vda, Dd, Dd^Vda, Dd, Gs^Ft, Dd, Rd, Rd, Gs^Ft, Gs^Ft, Gs, Ww, Ww, Hd, Hd, Hd, Hd, Gs^Ft, Gs, Gs, Re, Gs, Gs, Dd, Dd, Dd
Dd, Dd, Dd, Ww, Hd, Hd, Md, Md, Hd, Hd, Hd, Rd, Dd, Rd, Rd, Ww, Dd, Dd, Dd, Dd, Rd, Rd, Gs^Ft, Gs, Gs, Gs, Gs, Gs, Gs^Ft, Ww, Ww, Dd, Dd, Dd, Rd, Re, Gs, Gs, Dd, Ww, Ww, Ww
Gs^Ft, Dd, Dd, Ww, Hd, Hd, Md, Hd, Hd, Hd, Dd, Dd, Dd, Ww, Dd^Vda, Rd, Re, Dd, Rd, Rd, Dd, Dd, Gs^Ft, Gs, Gs, Gs, Ww, Gs, Gs, Ww, Gs, Gs, Rd, Rd, Dd, Dd, Gs^Ft, Dd, Ww, Ww, Ww, Ww
Gs, Dd, Dd, Ww, Hd, Md, Hd, Hd, Dd, Hd, Dd, Dd, Dd, Ww, Dd, Dd, Re, Re, Dd, Dd, Dd, Dd, Gs, Gs, Gs, Ww, Ww, Ww, Gg^Vh, Ww, Re, Rd, Gs, Dd, Dd, Dd, Ww, Ww, Ww^Vm, Ww, Ww, Ww
Gs, Dd, Dd, Ww, Hd, Md, Hd, Hd, Hd, Hd, Dd, Dd, Dd, Dd, Dd, Gs, Re, Gs, Dd, Dd, Dd, Gs^Ft, Gs, Gs, Ww, Ww, Gs, Ww, Ww, Ww, Rd, Hd, Gs^Ft, Dd, Ww, Ww, Dd, Ww, Ww, Ww, Ww, Ww
Gs, Gs^Ft, Gs^Ft, Ww, Ww, Hd, Md, Hd, Hd, Hd, Rd, Rd, Rd, Dd, Rd, Rd, Re, Dd, Dd, Dd, Gs^Ft, Gs^Ft, Gs, Dd, Ww, Gs, Gs, Ww, Ww, Gs, Re, Hd, Gs^Ft, Dd, Ww, Dd, Dd, Dd, Dd, Ww, Ww, Ww
Dd, Gs, Gg^Vh, Ww, Ww, Hd, Hd, Hd, Gs^Ft, Rd, Dd, Dd, Dd, Rd, Dd, Dd, Rd, Dd, Dd, Gs^Ft, Gs, Gs, Gs, Gs, Ww, Gs, Gg^Vh, Ww, Re, Re, Hd, Hd, Ww, Ww, Ww, Dd, Gs^Ft, Gs^Ft, Gs, Dd, Gs, Gs^Ft
Ww, Ww, Hd, Ww, Hd, Hd, Hd, Gs, Re, Re, Ww, Gg^Vh, Gs^Ft, Dd, Dd, Dd, Dd, Rd, Rd, Gs^Ft, Gs, Gs, Gg^Vh, Ww, Ww, Gs, Re, Re, Gs, Hd, Dd^Vdt, Ww, Ww, Ww, Hd, Hd, Gs^Ft, Gs, Gs, Dd, Gs, Gs
Ww, Ww, Ww, Ww, Hd, Hd, Hd, Gs, Re, Hd, Ww, Ww, Ww, Gs^Ft, Gs, Gs, Gs, Dd, Dd, Rd, Re, Gs, Gs, Ww, Ww, Dd, Re, Gs, Gs, Ww, Ww, Ww, Ww, Ww, Ww, Hd, Hd, Dd, Dd, Gs, Gs, Gs
Ww, Ww, Ww, Ww, Ww^Bw/, Ch, Rd, Re, Gs, Ww, Hd, Gs^Ft, Gs^Ft, Ww, Ww, Gs, Gs, Gs^Ft, Hd, Hd, Re, Gs, Gs, Dd, Ww, Gs, Re, Gs, Gs, Hd, Md, Ww, Ww^Vm, Ww, Md, Md, Md, Hd, Dd^Vda, Dd, Gs, Gs^Ft
Ww, Ch, Ch, Rd, Ww, Ww, Hd, Hd, Ww, Ww, Hd, Dd, Gs^Ft, Gs, Ww, Gs, Gs, Gs, Gs, Hd, Re, Gs, Gs, Gs, Gs, Gs, Re, Gs, Hd, Hd, Hd, Ww, Ww, Md, Md, Md, Md, Hd, Dd, Dd, Gs, Gs^Ft
Ww, Ww, Ww, Ww, Ww, Ww, Ww, Ww, Ww, Dd^Vdt, Hd, Hd, Dd, Gs, Gs^Ft, Ww, Gg^Vh, Gs, Gs, Gs, Re, Gs, Gs, Gs, Gs, Gs, Re, Gs, Gs, Hd, Hd, Md, Md, Md, Md, Md, Md, Md, Hd, Dd, Gs, Gs^Ft
Hd, Ww, Dd^Vdt, Ww, Ww, Ww, Ww, Ww, Md, Md, Md, Hd, Dd, Dd, Dd, Ww, Ww, Gs, Gs, Gs, Gs, Re, Re, Gs, Re, Re, Gs, Gs, Gs, Gs, Hd, Md, Md, Md, Md, Md, Md, Md, Hd, Hd, Gs, Gs^Ft
Hd, Hd, Hd, Ww, Ww, Ww, Ww, Ww, Ww, Md, Md, Hd, Hd, Dd, Dd, Gs^Ft, Ww, Gs, Gs, Gs, Gs, Gs, Gg^Vh, Re, Gs, Gs, Hd, Gs, Gs, Gs, Hd, Hd, Md, Md, Md, Md, Md, Md, Hd, Hd, Hd, Dd
Gs, Gs, Gs, Dd, Hd, Md, Md, Ww, Md, Md, Md, Md, Hd, Dd, Gs^Ft, Gs, Ww, Ww, Gs, Gs, Gs, Gs, Gs, Re, Gs, Hd, Hd, Gs, Gs, Gs, Gs, Hd, Hd, Md, Md, Hd, Hd, Hd, Hd, Hd, Hd, Hd
Gs, Gs, Gs, Gs^Ft, Dd, Hd, Md, Md, Md, Md, Md, Md, Hd, Gs, Gs, Gs, Gs, Ww, Dd, Gs, Gs, Gs, Gs, Re, Gs, Gs, Gs^Vht, Gs, Gs, Gs^Ft, Gs, Gs, Gs, Hd, Hd, Hd, Dd, Dd, Hd, Hd, Hd, Hd
Gs, Gs, Gs, Gs, Hd, Hd, Md, Md, Md, Md, Md, Md, Hd, Hd, Gs, Gs, Gs, Dd, Dd, Gs^Ft, Gs, Gs, Re, Re, Gs, Gs^Ft, Gs^Ft, Gs^Ft, Gs, Gs^Ft, Gs^Ft, Gs, Gs^Ft, Dd, Dd, Dd, Dd^Vda, Dd, Dd, Hd, Gs^Ft, Gs
Gs^Ft, Gs, Gs, Gs, Gs, Hd, Md, Md, Md, Md, Md, Hd, Md, Hd, Gs^Ft, Gs, Gs, Gs, Gs^Ft, Gs, Re, Re, Gs, Gs, Gs, Gs, Gs^Ft, Gs^Ft, Gs^Ft, Dd, Dd, Dd, Dd, Dd, Dd, Dd, Dd, Dd, Dd, Dd, Gs, Gs
Dd, Dd, Gs^Ft, Gs, Hd, Hd, Hd, Hd, Hd, Hd, Hd, Hd, Hd, Gs, Gs, Gs, Gs, Gs, Gs, Gs, Re, Gs, Gs, Gs, Gs, Gs, Gs, Dd, Dd, Ww, Ww, Ww, Dd, Dd, Dd, Dd, Dd, Gs^Ft, Gs^Ft, Gs, Gs, Gs
Gs^Ft, Gs^Ft, Dd, Dd, Dd, Dd, Dd, Dd, Dd, Gs^Ft, Gs, Gs, Gs, Gs, Gs^Ft, Gs, Gs^Ft, Gs, Re, Re, Gs, Re, Re, Gs, Gs, Gs, Gs, Dd, Ww, Ww, Ww, Dd^Vda, Ww, Dd, Dd, Dd, Dd, Gs^Ft, Gs, Gs, Gs, Gs
Hd, Hd, Hd, Dd, Dd, Dd, Rd, Rd, Re, Gs, Gs, Gs, Gs, Gs, Re, Gg^Vh, Re, Rd, Gs, Gs, Gs, Gs, Re, Gs, Gs, Gs, Dd, Ww, Ww, Ww, Ww, Dd, Dd, Dd, Dd, Dd, Dd, Dd, Gs^Ft, Gs, Gs, Gs
Hd, Hd, Gs^Ft, Dd, Dd, Rd, Dd^Vda, Dd, Gg^Vh, Rd, Re, Re, Re, Re, Gs, Re, Gs, Gs, Gs, Gs, Gs, Gs, Re, Gs, Gs, Gs, Ww, Ww, Dd, Ww, Dd, Dd, Dd, Dd, Dd, Dd, Dd, Dd, Dd, Gs^Ft, Gs, Gs
Md, Hd, Dd, Dd, Dd, Rd, Dd, Ww, Ww, Ww, Ww, Dd, Gs, Gs, Gs, Gs, Gs^Ft, Gs, Gs, Gs, Gs, Gs, Re, Gg^Vh, Gs, Gs, Gg^Vh, Gs^Ft, Dd, Dd, Dd, Dd, Dd, Dd, Dd, Dd, Dd, Dd, Dd, Dd, Ww, Gs
Md, Hd, Dd, Ch, Ch, Ch, Dd, Ww, Ww, Wo, Wo, Ww, Dd, Gs^Ft, Gs, Gs, Gs, Gs, Gs, Gs, Gs, Gs^Ft, Gs, Re, Re, Gs, Re, Gs, Gs, Gs^Ft, Dd, Dd, Dd^Vda, Dd, Dd, Hd, Gs^Ft, Dd, Dd, Dd^Vda, Ww, Ww
Hd, Hd, Dd, Ch, 2 Kh, Ch, Dd, Ww, Ww, Ww, Ww, Ww, Dd^Vda, Dd, Gs, Gs, Gs, Gs, Dd, Dd, Hd, Dd, Hd, Hd, Hd, Re, Gs, Re, Re, Gs, Gs^Ft, Dd, Dd, Dd, Dd, Gs, Hd, Hd, Dd, Dd, Ww, Ww
Hd, Dd, Ch, Ch, Ch, Dd, Ww, Ww, Ww, Ww, Ww, Dd, Dd, Gs^Ft, Gs, Gs, Hd, Hd, Hd, Hd, Hd, Hd, Hd, Hd, Hd, Hd, Hd, Gs, Gs, Re, Re, Gs, Gs^Ft, Dd, Gs^Ft, Hd, Md, Md, Hd, Hd, Ww, Ww
Hd, Dd, Dd, Dd, Dd, Ww, Ww, Wo, Ww, Ww, Dd, Dd, Dd, Gs, Gs, Gs, Hd, Hd, Hd, Hd, Hd, Hd, Hd, Hd, Hd, Hd, Hd, Hd, Gs, Gs, Re, Gs, Gs, Gs, Gs, Hd, Md, Ww, Ww, Md, Ww, Ww
Hd, Dd, Dd, Gs^Ft, Ww, Ww, Wo, Wo, Ww, Ww, Dd, Dd, Gs^Ft, Gs, Gs, Gs, Hd, Hd, Hd, Hd, Hd, Hd, Hd, Hd, Hd, Hd, Hd, Hd, Hd, Gs, Re, Gs, Dd, Gs, Gs, Hd, Md, Md, Ww, Ww, Ww, Ww
Hd, Gs^Ft, Gs^Ft, Gs^Ft, Ww, Ww, Wo, Ww, Ww, Dd^Vda, Dd, Dd, Gs^Ft, Gs, Gs, Hd, Hd, Hd, Hd, Hd, Dd, Dd, Dd, Dd, Dd, Hd, Hd, Hd, Hd, Gs, Re, Gs, Dd, Dd, Gs, Hd, Md, Ww, Ww, Ww, Ww, Ww
Gs, Gs, Gs, Gg^Vh, Dd, Ww, Ww, Dd, Dd, Dd, Dd, Gs^Ft, Gs, Gs, Gs, Hd, Hd, Hd, Hd, Gs, Gs^Ft, Dd, Dd, Dd, Dd, Dd, Dd, Hd, Hd, Gs, Rd, Dd, Ww, Dd, Gs^Ft, Ww, Ww, Ww, Ww^Vm, Ww, Ww, Md
Hd, Hd, Gs, Gs, Gs^Ft, Dd, Ww, Dd, Dd, Dd, Gs, Gs, Gs, Gs, Gg^Vh, Gs, Gs, Gs, Gs, Gs, Gs, Gs, Dd, Gs^Ft, Dd, Dd, Dd, Dd, Gs^Ft, Gs^Ft, Rd, Dd, Dd, Dd, Dd, Hd, Ww, Ww, Ww, Ww, Ww, Md
Gs, Hd, Hd, Gs, Gs, Gs^Ft, Dd, Dd, Dd, Dd, Dd, Dd, Dd, Gs, Gs, Hd, Hd, Gs, Gs, Gs, Gs, Gs, Ww, Dd, Gs, Dd, Dd, Dd, Gs^Ft, Dd, Dd, Rd, Rd, Dd, Dd, Hd, Md, Md, Md, Md, Md, Rd
