Gs^Ft, Dd, Dd, Dd, Dd, Dd, Dd, Gs^Ft, Dd, Dd, Dd, Dd, Dd, Gs, Gs, Gs, Ww, Ww, Ww, Ww, Md, Md, Hd, Hd, Hd, Gs^Ft, Gs^Ft, Gs^Ft, Rd, Rd, Gs^Ft, Gs, Gs, Gs, Gs, Gs^Ft, Dd, Gs^Ft, Gs, Gs, Gs, Gs
Gs, Gs^Ft, Dd, Dd, Dd, Dd, Gs, Gs, Gs, Gs, Gs^Ft, Dd, Gs^Ft, Gs, Gs, Gs, Gs, Hd, Hd, Ww, Ww, Hd, Hd, Hd, Hd, Dd, Gs^Ft, Gs^Ft, Re, Gs^Ft, Dd, Gs, Gs, Gs, Gs, Gs^Ft, Dd, Dd, Gs^Ft, Gs, Gs, Gs
Hd, Gs, Gs, Gs^Ft, Gs, Gs, Gs, Gs, Re, Gs, Gs, Gs, Gs^Ft, Gs, Gs, Dd, Dd, Dd, Dd, Hd, Hd, Ww, Ww, Gs, Gs^Ft, Dd, Gs^Ft, Re, Gs, Gs^Ft, Gs^Ft, Dd, Gs, Gs, Gs, Gs, Gs^Ft, Dd, Gs^Ft, Gs, Gs, Gs
Gs, Gs, Gs^Ft, Gs, Re, Re, Re, Re, Gs, Re, Re, Gs, Gs, Gs, Gs^Ft, Dd, Dd, Dd, Dd, Dd, Gs^Ft, Gg^Vh, Ww, Gs, Gs^Ft, Dd, Re, Re, Gs, Gs, Gs^Ft, Hd, Gs^Ft, Gs, Gs, Ch, Ch, Ch, Gs^Ft, Gs, Gs, Gs
Hd, Gs^Ft, Rd, Re, Gs, Gs, Gs, Gs, Gs, Gs, Gs^Vht, Re, Rd, Gs^Ft, Gs^Vht, Gs^Ft, Dd, Dd, Dd, Gs^Ft, Gs, Gs, Gs, Ww, Ww, Ww, Ch, Gg^Vh, Gs, Gs^Ft, Gs^Ft, Gs^Ft, Hd, Hd, Hd, Ch, 1 Kh, Ch, Gs^Ft, Dd, Gs, Gs
Hd, Re, Gs, Gs, Gs, Gs, Gs, Gs, Gs, Gs^Ft, Gs^Ft, Dd, Dd, Rd, Re, Rd, Rd, Dd, Gs^Ft, Gs, Gs, Gs, Gs, Dd, Rd, Rd, Ww, Ww, Gs^Ft, Dd, Dd, Hd, Hd, Hd, Ch, Ch, Ch, Gs, Gs^Ft, Gs^Ft, Gs^Ft, Gs
Rd, Re, Gs, Gs, Gs, Gs, Gs, Hd, Hd, Hd, Dd, Dd, Dd, Gs^Ft, Gs, Gs, Gs^Ft, Re, Re, Re, Re, Gs, Gs, Gs, Rd, Dd, Dd, Ww, Dd, Dd, Dd, Hd, Hd, Hd, Hd, Hd, Rd, Hd, Dd, Dd, Gs^Ft, Gs
Md, Gs, Gs, Gs, Gs, Gs, Hd, Hd, Hd, Hd, Gs^Ft, Dd, Gs^Ft, Gs, Gs, Gs, Gs, Gs, Gs, Gs, Gs, Re, Re, Gs, Rd, Dd, Dd^Vda, Ww, Dd, Dd, Dd, Hd, Hd, Hd, Dd^Vdt, Rd, Hd, Hd, Dd, Dd, Gs^Ft, Gs^Ft
Md, Hd, Gs, Gs^Ft, Dd, Gs, Hd, Md, Md, Md, Hd, Gs^Ft, Gs, Gs, Gs, Gs, Gs, Gs, Gs^Ft, Gs^Ft, Gs^Ft, Gs, Re, Gg^Vh, Rd, Dd, Dd, Ww, Dd, Dd, Dd, Hd, Hd, Hd, Hd, Rd, Hd, Hd, Dd, Dd, Gs^Ft, Gs
Md, Gg^Vh, Gs^Ft, Dd, Gs^Ft, Gs, Hd, Md, Md, Md, Hd, Hd, Gs^Ft, Gs^Vht, Gs^Ft, Gs^Ft, Gs, Gs^Ft, Dd, Dd, Gs^Ft, Gs, Gs, Re, Gs^Ft, Dd, Dd, Ww, Dd, Dd, Gs^Ft, Hd, Hd, Hd, Hd, Rd, Dd, Dd, Dd^Vda, Dd, Dd, Dd
Ww, Ww, Dd, Gs^Ft, Gs, Gs, Md, Md, Md, Md, Md, Hd, Gs^Ft, Dd, Dd, Dd, Dd, Gs^Ft, Dd, Gs^Ft, Gs^Ft, Gs, Gs, Re, Gs^Ft, Dd, Dd, Ww, Dd, Dd, Gs^Ft, Dd, Hd, Dd, Rd, Rd, Dd, Dd, Dd, Dd, Dd, Dd
Ww, Ww, Dd, Gs^Ft, Gs, Gs, Md, Md, Md, Md, Md, Hd, Hd, Hd, Hd, Hd, Hd, Hd, Hd, Gs, Gs, Gs^Ft, Gs, Re, Gs, Dd, Dd, Ww, Dd, Dd, Rd, Rd, Rd, Rd, Dd, Dd, Dd, Dd, Dd, Dd, Dd, Dd
Ww, Dd, Dd, Gs^Ft, Gs, Gs, Hd, Md, Md, Md, Md, Hd, Hd, Hd, Hd, Hd, Hd, Hd, Hd, Hd, Gs, Gs, Re, Re, Dd, Ww, Ww, Ww, Dd, Rd, Dd, Dd, Dd, Dd, Dd, Dd, Dd, Dd, Dd, Dd, Dd, Dd
Ww, Dd, Dd, Dd, Gs^Ft, Gs, Gs, Hd, Md, Md, Hd, Hd, Hd, Md, Md, Hd, Md, Hd, Hd, Hd, Gs^Ft, Dd, Rd, Rd, Dd, Ww, Ww, Dd^Vda, Dd, Rd, Dd, Dd, Dd, Dd, Dd, Dd, Dd, Dd, Dd, Gs^Ft, Dd, Dd
Hd, Ww, Ww, Dd, Gs^Ft, Gs, Gs, Hd, Hd, Hd, Hd, Hd, Hd, Hd, Md, Hd, Md, Md, Md, Hd, Dd, Dd, Rd, Rd, Rd, Dd, Dd, Dd, Rd, Rd, Dd, Dd, Dd, Dd, Dd, Dd, Dd, Dd, Dd, Gs, Gs, Dd
Md, Hd, Dd, Ww, Ww, Gs, Gs, Dd, Dd, Dd, Dd, Dd, Dd, Hd, Hd, Md, Md, Md, Md, Hd, Dd, Dd^Vda, Rd, Gs^Ft, Rd, Dd, Ww, Dd, Rd, Dd, Dd, Dd, Dd, Dd, Dd, Dd, Dd, Dd^Vda, Ww, Dd, Gs, Gs
Md, Hd, Gs, Gg^Vh, Ww, Gs, Gs, Dd, Dd, Dd^Vda, Dd, Dd, Dd, Hd, Hd, Hd, Md, Md, Md, Hd, Dd, Dd, Rd, Rd, Gs^Ft, Gs^Ft, Ww, Gs^Ft, Rd, Dd, Dd, Dd, Dd, Dd, Dd^Vda, Ww, Ww, Dd, Ww, Ww, Dd, Gs
Md, Hd, Hd, Gs, Gs, Ww, Ww, Ww, Dd, Dd, Dd, Dd, Gs^Ft, Gg^Vh, Hd, Hd, Hd, Hd, Hd, Gs^Ft, Dd, Dd, Rd, Re, Gs, Gs, Dd, Re, Gs, Gs^Ft, Gs, Dd, Dd, Dd, Ww, Ww, Ww, Ww, Ww, Ww, Dd, Gs
Md, Hd, Gs, Gs, Gs, Gs, Gs^Ft, Ww, Ww, Ww, Dd, Dd, Gs^Ft, Dd, Gs, Hd, Hd, Hd, Hd, Gs^Ft, Dd, Gs^Ft, Re, Re, Gs, Gs, Re, Re, Gs, Gs, Gs, Gs^Ft, Dd, Dd, Ww, Ww, Ww, Ww, Ww, Ww, Gs, Gs
Md, Hd, Gs, Gs, Gs, Gs^Ft, Dd, Dd, Ww, Ww, Ww, Dd, Dd, Dd, Gs^Ft, Hd, Hd, Hd, Gs, Gs^Ft, Gs^Ft, Dd, Gs^Ft, Re, Re, Gs, Re, Gs, Gs, Hd, Gs, Gs, Dd, Dd, Ww, Ww, Wo, Wo, Ww, Ww, Gs, Gs
Hd, Gs, Gs, Gs, Gs, Dd, Gs^Ft, Gs^Ft, Dd, Ww, Ww, Ww, Dd, Dd, Gs^Ft, Hd, Hd, Hd, Hd, Gs, Gs, Gs, Gs, Gs, Re, Rd, Dd, Gs^Ft, Gs^Ft, Gs, Gs, Dd, Dd, Dd, Ww, Ww, Wo, Wo, Ww, Ww, Dd, Gs
Gs, Gs, Gs, Gs, Gs, Gs, Gs^Ft, Gs^Ft, Gs^Ft, Dd, Dd, Dd^Vda, Dd, Dd, Gs^Ft, Hd, Md, Md, Hd, Gs, Gs, Gs, Gs, Gs, Re, Rd, Gs^Ft, Gs^Ft, Dd, Dd, Dd, Dd, Dd, Dd^Vda, Ww, Ww, Wo, Wo, Ww, Ww, Dd, Gs^Ft
Gs, Gs, Gs, Gs, Dd, Dd, Dd, Dd, Dd, Dd, Dd, Dd, Gs^Ft, Dd, Gs^Ft, Hd, Md, Hd, Hd, Hd, Gs, Gs, Gs, Gs, Gs, Re, Gs, Gs, Dd, Dd^Vda, Dd, Dd, Dd, Dd, Ww, Ww, Ww, Ww, Ww, Ww, Dd^Vda, Gs
Gs, Gs, Gs, Gs, Dd, Hd, Hd, Dd, Dd, Dd, Dd, Dd, Gs^Ft, Dd, Dd^Vdt, Hd, Hd, Md, Hd, Gs, Gs, Gs, Gs, Gs, Re, Re, Gs, Gs, Gs^Ft, Dd, Dd, Dd, Dd, Dd, Dd, Ww, Ww, Ww, Ww, Ww, Ww, Gs
Ww, Gs, Gs, Gs^Ft, Dd, Hd, Hd, Dd, Dd, Dd, Dd, Dd, Dd, Dd, Hd, Hd, Md, Md, Hd, Gs, Gs, Gs, Gs, Gg^Vh, Re, Gs, Gs, Gs, Gs, Dd, Dd, Dd, Dd, Dd, Dd, Dd, Ww, Ww, Ww, Ww, Ww, Dd
Ww, Gs, Gs, Dd, Dd, Dd, Dd, Dd, Dd, Dd, Dd, Dd, Dd, Gs^Ft, Hd, Hd, Md, Hd, Hd, Gs, Gs, Gs, Gs, Gs, Re, Gs, Gs, Gs, Gs, Gs^Ft, Dd, Dd, Dd, Dd, Dd, Gs, Gs^Ft, Dd, Ww, Ww, Ww, Dd
Ww, Dd, Gs, Dd, Dd, Dd, Dd, Dd, Dd, Dd, Dd, Dd, Gs^Ft, Gs^Ft, Hd, Hd, Hd, Hd, Gs, Gs, Gs, Gs, Gs, Gs, Re, Gs, Gs, Gs, Gs, Gs^Ft, Dd, Dd, Dd, Dd, Gs^Ft, Gs, Gs, Dd, Ww, Ww, Ww, Dd
Dd, Dd, Gs^Ft, Gs^Ft, Dd, Gs^Ft, Gs, Gs, Gs^Ft, Gs^Ft, Dd, Dd, Gs^Ft, Hd, Hd, Hd, Hd, Hd, Gs, Gs, Gs, Gs, Gs, Gs, Re, Gs, Gs, Gs, Gs, Gs^Ft, Dd, Dd^Vda, Dd, Hd, Hd, Gs, Gs, Dd, Dd, Dd^Vda, Dd, Dd
Gs^Ft, Gs^Ft, Gs, Gs, Gs, Gs^Ft, Gs, Gs, Gs^Ft, Gs^Ft, Gs^Ft, Dd, Hd, Hd, Hd, Hd, Hd, Hd, Gs, Gs, Re, Gs, Re, Re, Gs, Gs, Gs, Gs, Gs, Gs^Ft, Dd, Dd, Hd, Hd, Hd, Hd, Gs, Dd, Dd, Dd, Dd, Dd
Gs^Ft, Gs, Gs, Gs, Gs, Gs, Gs, Gs, Gg^Vh, Gs, Hd, Gs^Ft, Hd, Hd, Hd, Gs^Ft, Dd, Gs^Ft, Gs, Re, Gg^Vh, Re, Gs^Ft, Gs^Ft, Gs^Ft, Gs^Ft, Gs, Gs, Dd, Dd, Gs^Ft, Gs, Hd, Hd, Hd, Hd, Gs, Gs^Ft, Dd, Dd, Dd, Dd
Hd, Gs^Ft, Gs, Gs^Ft, Dd, Dd, Ww, Ww, Gs^Ft, Gs^Ft, Gs^Ft, Hd, Dd, Dd, Dd, Dd, Dd, Gs^Ft, Gs, Re, Gs, Gs^Ft, Dd, Dd, Gs^Ft, Dd, Dd, Dd, Dd, Dd, Gs, Gs, Gs, Hd, Hd, Gs, Gs, Gs, Gs^Ft, Dd, Dd, Ww
Gs, Gs^Ft, Dd, Dd, Dd, Dd^Vda, Dd, Dd, Rd, Rd, Rd, Dd, Hd, Dd, Dd^Vda, Dd, Gs^Ft, Gs, Gs, Re, Gs, Dd, Dd, Gs^Ft, Dd, Dd, Dd, Dd^Vda, Dd, Dd, Gs, Gs, Gs, Gs, Gs^Ft, Gs, Gs, Gs, Gs^Ft, Ww, Ww, Dd
Hd, Dd, Dd, Dd, Dd, Dd, Rd, Rd, Dd, Dd^Vda, Dd, Rd, Rd, Dd, Dd, Dd, Gs, Gs, Re, Re, Gs^Ft, Dd, Gs^Ft, Gs, Gs^Ft, Dd, Dd, Dd, Dd, Dd, Gs^Ft, Gs, Gs, Gs, Gs, Gs, Gs, Gs, Dd, Ww, Ww, Dd
Hd, Dd, Dd, Dd, Dd, Dd, Rd, Hd, Hd, Hd, Hd, Hd, Rd, Dd, Gs^Ft, Gs^Ft, Re, Re, Gs, Re, Gs^Ft, Gs^Ft, Gs, Gs^Ft, Dd, Dd, Dd, Dd, Dd, Dd, Dd, Gs, Gs^Ft, Gs, Gs, Gs, Gs, Gs, Ww, Ww, Ww, Dd
Gs, Dd, Dd, Dd, Rd, Rd, Hd, Md, Md, Hd, Hd, Hd, Dd, Re, Re, Re, Gs, Dd, Gs, Re, Gs, Gs, Gs, Gs^Ft, Dd, Dd^Vda, Dd, Dd, Dd, Dd, Dd, Ww, Ww, Ww, Ww, Gs, Gs, Dd, Ww, Ww, Ww, Ww
Gs, Dd, Dd, Ch, Ch, Ch, Md, Md, Md, Md, Md, Hd, Gs^Ft, Gs, Re, Ww, Ww, Ww, Dd, Re, Re, Gs, Gs^Ft, Dd, Dd, Dd, Dd, Dd, Dd, Dd, Dd, Dd, Gs^Ft, Ww, Ww, Gs, Gs, Gs, Gg^Vh, Ww, Ww, Ww
Dd, Dd, Dd, Ch, 2 Kh, Ch, Md, Md, Md, Md, Md, Hd, Gs^Ft, Gs, Re, Ww, Ww, Ww, Dd, Dd, Gg^Vh, Rd, Rd, Gs^Ft, Gs, Gs^Ft, Gs, Gs^Ft, Dd, Dd, Dd, Dd, Dd, Dd, Gs^Ft, Gs, Gs, Gs, Gs, Dd, Ww, Ww
Dd, Dd, Ch, Ch, Ch, Hd, Md, Md, Md, Md, Md, Hd, Dd, Gs^Ft, Re, Gg^Vh, Ww, Dd, Dd, Dd, Ww, Dd, Gs^Ft, Re, Gs, Gs, Gs, Gs, Gs, Gs^Ft, Dd, Dd^Vda, Dd, Dd, Dd, Dd, Gs^Ft, Gs, Gs^Ft, Gs^Ft, Ww, Ww
Dd, Dd, Dd, Dd, Dd, Dd, Md, Md, Md, Md, Md, Hd, Dd, Dd, Rd, Gs^Ft, Gs, Gs, Gs, Gs^Ft, Dd, Gs^Ft, Gs, Re, Re, Gs, Gs, Gs, Gs, Dd, Dd, Dd, Dd, Dd, Dd, Dd, Dd, Gs^Ft, Dd, Gs^Ft, Dd, Dd
Ww, Dd, Dd, Dd^Vda, Dd, Dd, Dd, Hd, Hd, Md, Hd, Hd, Hd, Gs^Ft, Rd, Gs^Ft, Gs, Gs, Gs, Gs^Ft, Gs^Ft, Gs^Ft, Gs, Gs, Gs, Re, Re, Gs, Gs, Gs^Ft, Dd, Dd, Dd, Gs, Dd, Dd, Dd, Dd, Dd, Gs^Ft, Gs^Ft, Dd
Dd, Ww, Dd, Ww, Dd, Dd, Gs^Ft, Hd, Hd, Hd, Hd, Hd, Hd, Gs^Ft, Rd, Dd, Gs^Ft, Gs^Ft, Gs^Ft, Gs^Ft, Gs^Ft, Gs^Ft, Gs^Ft, Gs, Gs^Ft, Hd, Hd, Rd, Hd, Hd, Hd, Hd, Dd, Dd, Dd, Dd, Dd, Dd, Dd, Gs^Ft, Gs^Ft, Gs^Ft
Dd, Ww, Ww, Ww, Dd, Dd, Gs^Ft, Gs^Ft, Hd, Gs, Gs, Hd, Rd, Rd, Hd, Hd, Hd, Hd, Gs^Ft, Gs^Ft, Gs, Gs^Ft, Gs, Gs, Gs^Ft, Hd, Md, Rd, Md, Md, Md, Hd, Hd, Dd, Dd, Dd, Dd, Dd, Dd, Dd, Gs^Ft, Gs^Ft
