Gs, Gs, Gs, Gs, Hd, Hd, Hd, Dd, Dd, Dd, Dd, Dd, Dd, Dd, Dd, Dd, Gs^Ft, Gs^Ft, Gs, Hd, Hd, Hd, Rd, Dd, Gs, Dd, Dd, Dd, Dd, Dd, Dd, Dd, Hd, Dd, Dd, Dd, Gs, Gs, Ww, Ww, Dd, Dd
Gs, Gs, Gs^Ft, Hd, Hd, Hd, Dd, Dd, Dd, Dd, Dd, Dd, Dd, Dd, Dd, Dd, Dd, Gs^Ft, Hd, Md, Md, Hd, Dd^Vdt, Rd, Hd, Dd, Dd, Dd, Dd, Dd, Dd, Dd, Dd, Dd, Dd^Vda, Dd, Gs^Ft, Gs, Dd, Dd, Ww, Ww
Dd, Dd, Gs^Ft, Hd, Hd, Gs, Dd, Dd, Dd, Dd, Dd, Dd, Dd, Dd, Dd, Dd, Dd, Hd, Hd, Md, Md, Md, Hd, Rd, Rd, Hd, Hd, Hd, Dd, Dd^Vda, Dd, Dd, Dd, Dd, Dd, Ww, Dd, Gs^Ft, Gs, Dd, Ww, Ww
Dd, Dd, Dd, Hd, Hd, Gs^Ft, Gs^Ft, Ch, Ch, Ch, Dd, Dd, Dd, Dd^Vda, Dd, Dd, Hd, Hd, Md, Md, Md, Md, Md, Hd, Hd, Rd, Hd, Hd, Dd, Dd, Dd, Dd, Dd, Dd, Dd, Ww, Ww, Gg^Vh, Dd, Dd, Ww, Ww
Dd, Dd, Dd, Dd, Dd, Dd, Gs^Ft, Ch, 1 Kh, Ch, Dd, Dd, Dd, Dd, Dd, Hd, Hd, Md, Md, Md, Md, Md, Md, Hd, Hd, Rd, Hd, Hd, Dd, Dd, Gs^Ft, Dd, Gs^Ft, Dd, Ww, Ww, Ww, Ww, Ww, Ww, Ww, Ww
Ww, Dd, Dd, Dd, Dd, Gs^Ft, Ch, Ch, Ch, Rd, Dd, Dd, Dd, Dd, Dd, Hd, Hd, Md, Md, Md, Md, Md, Md, Hd, Hd, Rd, Hd, Dd, Dd, Dd, Dd, Gs^Ft, Gs^Ft, Dd, Ww, Ww, Ww, Ww, Ww, Ww, Ww, Ww
Ww, Ww, Ww, Dd, Dd, Gs^Ft, Gs, Gs, Gs, Re, Re, Gs^Ft, Dd, Dd, Hd, Hd, Hd, Hd, Md, Md, Md, Md, Hd, Hd, Re, Re, Dd, Dd, Dd, Gs, Gs, Dd, Gs^Ft, Gs^Vht, Ww, Ww, Ww, Ww, Wo, Ww, Ww, Ww
Ww, Ww, Ww, Ww, Dd, Gs, Dd, Gs, Dd, Gs^Ft, Rd, Gs^Ft, Dd, Dd, Dd, Hd, Hd, Hd, Md, Md, Md, Hd, Hd, Re, Gs, Gs, Gs^Ft, Dd, Gs^Ft, Hd, Gs, Gs, Gs, Gs^Ft, Dd, Ww, Ww, Ww, Ww, Ww, Ww, Ww
Ww, Ww, Ww, Dd, Gs, Gs, Gs, Gs, Gs^Ft, Dd, Dd^Vda, Rd, Dd, Dd, Dd, Dd, Hd, Hd, Hd, Md, Hd, Hd, Re, Re, Gs, Gs, Gs, Gs, Hd, Hd, Hd, Gs, Gs, Gs^Ft, Dd, Dd, Dd, Dd^Vda, Dd, Dd, Dd, Dd
Dd, Dd^Vda, Dd, Gs^Ft, Gs, Gs, Gs, Gs, Gs^Ft, Dd, Dd, Rd, Rd, Gs, Gs, Gs, Gs, Gs, Gs, Gs, Gs, Gs, Re, Gs, Gs, Gs, Gs, Hd, Hd, Hd, Hd, Hd, Gs, Gs^Ft, Dd, Dd, Dd, Dd, Dd, Dd, Dd, Dd
Dd, Dd, Dd, Gs^Ft, Gs, Gs, Gs, Gs, Gs, Dd, Dd, Dd, Rd, Gs, Gs, Gs, Gs, Gs, Gs, Gs, Re, Re, Gs, Gs, Gs, Gg^Vh, Hd, Hd, Hd, Md, Md, Hd, Hd, Hd, Dd, Dd, Dd, Dd, Dd, Dd, Dd, Hd
Dd, Dd, Dd, Dd, Gs, Gs, Gs, Gs, Gs, Gs^Ft, Gs^Ft, Gs^Ft, Gs, Re, Re, Gs, Gs, Gs, Re, Re, Dd, Gs^Ft, Gs, Gs, Hd, Hd, Hd, Hd, Hd, Hd, Md, Md, Md, Hd, Gs^Ft, Dd, Dd, Dd, Dd, Dd, Hd, Hd
Dd, Dd, Dd, Dd, Dd, Gs, Hd, Gs, Gs, Hd, Gs, Gs, Gs, Dd, Re, Gg^Vh, Re, Re, Gs, Dd, Dd^Vda, Dd, Gs^Ft, Gs, Hd, Hd, Hd, Hd, Hd, Hd, Md, Md, Md, Hd, Gs, Dd, Dd, Dd, Dd, Hd, Hd, Md
Dd, Dd, Dd, Dd, Dd, Gs, Gs, Hd, Gs, Hd, Gs, Gs, Gs, Gs, Re, Re, Gs, Gs^Ft, Dd, Dd, Dd, Dd, Dd, Hd, Hd, Hd, Hd, Hd, Hd, Hd, Hd, Hd, Hd, Hd, Gs^Ft, Dd, Dd, Dd, Dd, Hd, Hd, Md
Dd, Dd, Dd, Dd, Gs^Ft, Gs, Gs^Ft, Dd, Hd, Gs^Ft, Gs, Gs, Gs, Gs, Re, Gs, Gs, Dd, Dd, Dd, Dd, Dd, Dd, Hd, Hd, Hd, Hd, Hd, Dd, Hd, Hd, Hd, Hd, Gs, Dd, Dd, Dd, Dd, Dd, Hd, Hd, Hd
Dd, Dd, Dd, Dd, Dd, Dd, Dd, Dd, Dd^Vda, Dd, Dd, Gs, Gs, Gs, Gs, Re, Re, Gs^Ft, Dd, Dd, Dd^Vda, Dd, Hd, Hd, Hd, Hd, Hd, Hd, Dd, Dd, Hd, Hd, Gs, Gs^Ft, Dd^Vda, Dd, Dd, Dd, Hd, Hd, Hd, Hd
Dd, Dd, Dd, Dd, Dd, Dd, Dd, Dd, Dd, Dd, Dd, Gs, Gs, Gs, Gs, Gg^Vh, Re, Gs, Gs^Ft, Dd, Dd, Dd, Hd, Hd, Hd, Hd, Hd, Hd, Dd, Dd, Hd, Gs, Gs^Ft, Dd, Dd, Dd, Dd, Gs^Ft, Gs, Gs, Dd, Dd
Gs, Gs, Gs^Ft, Dd, Dd, Dd, Dd, Dd, Gs, Gs, Dd, Dd, Gs, Gs, Gs, Gs, Gs, Re, Gs, Gs^Ft, Dd, Hd, Hd, Hd, Hd, Hd, Hd, Hd, Dd^Vda, Hd, Hd, Gs, Gs^Ft, Dd, Dd, Gs, Gs, Gs, Gs, Gs^Ft, Dd, Dd
Gs, Gs, Gs, Gs, Dd, Dd, Dd, Dd, Gs, Gs, Dd, Dd, Gs, Gs, Gs, Gs, Gs, Re, Gs, Gs, Dd, Hd, Hd, Hd, Hd, Hd, Hd, Hd, Hd, Hd, Hd, Gs, Dd, Dd^Vda, Dd, Gs^Ft, Gs, Gs, Gs, Dd, Dd^Vda, Dd
Gs, Gs, Gs, Gs, Dd, Dd, Dd, Dd, Dd, Dd, Dd, Dd, Gs^Ft, Gs, Gs, Gs, Re, Re, Hd, Hd, Hd, Hd, Md, Md, Hd, Hd, Hd, Hd, Hd, Hd, Hd, Hd, Hd, Dd, Dd, Gs^Ft, Dd, Gs, Gs, Dd, Dd, Dd
Dd, Gs^Ft, Gs, Gs, Gs, Gs^Ft, Dd, Hd, Dd, Dd^Vda, Dd, Dd, Gs, Gs, Gs, Re, Gs^Ft, Hd, Hd, Hd, Md, Md, Md, Hd, Md, Md, Hd, Hd, Hd, Hd, Hd, Hd, Hd, Dd, Dd, Gs^Ft, Gs, Gs, Gs, Dd, Dd, Dd
Dd, Gs^Vht, Gs, Gs, Gs, Gs, Dd, Hd, Dd, Dd, Dd, Dd, Dd, Gs, Gs, Re, Gs, Gs^Ft, Hd, Md, Md, Md, Md, Hd, Hd, Hd, Hd, Hd, Hd, Hd, Hd, Hd, Hd, Dd, Dd, Gs^Ft, Gs, Gs, Dd, Dd, Dd, Dd
Dd, Gs^Ft, Gs, Gs, Gs, Gs, Gs, Hd, Dd, Dd, Dd, Gs, Gs, Gs, Re, Re, Gs^Ft, Gs, Gs^Ft, Hd, Hd, Md, Hd, Hd, Hd, Dd, Dd, Hd, Hd, Hd, Hd, Md, Hd, Hd, Dd, Dd, Gs, Gs, Ww, Dd, Dd, Dd
Dd, Gs^Ft, Gs, Gs, Gs, Gs, Gs, Gs, Gs, Gs^Ft, Gs, Gs, Re, Rd, Gg^Vh, Re, Re, Gs, Gs, Gs^Ft, Md, Md, Md, Hd, Dd, Dd, Dd^Vda, Dd, Hd, Hd, Md, Hd, Hd, Dd, Dd, Dd, Gs, Ww, Ww, Ww, Dd, Dd
Gs, Gs, Gs, Gs, Gs, Gs, Gs, Gs, Re, Re, Re, Re, Dd, Ww, Ww, Ww, Dd, Re, Re, Gs, Hd, Md, Hd, Hd, Dd, Dd, Dd, Dd, Dd, Hd, Hd, Hd, Dd, Dd, Dd, Gs^Ft, Ww, Ww, Ww, Ww, Dd^Vda, Dd
Gs, Gs, Gs, Gs, Gs, Gs, Re, Re, Gs, Gs, Gs, Dd, Ww, Ww, Ww, Ww, Ww, Gs^Ft, Gs, Re, Re, Hd, Hd, Hd, Gs^Ft, Gs^Ft, Gs^Ft, Gs^Ft, Dd, Dd, Hd, Dd, Dd, Dd, Dd^Vda, Ww, Dd, Ww, Ww, Ww, Ww, Dd
Dd, Gs, Re, Gs, Re, Re, Gs, Gs, Dd, Dd, Dd, Ww, Ww, Ww, Ww, Ww, Ww, Gs^Ft, Gs, Gs, Gs^Ft, Rd, Re, Gs^Ft, Gs^Ft, Gs^Ft, Dd, Gs, Gs, Gs^Ft, Dd, Dd, Dd, Dd, Dd, Ww, Dd, Dd, Ww, Ww, Ww, Dd
Rd, Re, Gs, Re, Gs, Gs, Gs, Gs, Dd, Dd, Dd, Dd, Ww, Ww, Ww, Ww, Ww, Ww, Gs^Ft, Dd, Dd, Gs^Vht, Re, Gs, Gs^Ft, Gs^Ft, Dd, Gs, Gs, Gs, Gs^Ft, Dd, Dd, Dd, Dd, Dd, Dd, Dd, Ww, Ww, Ww, Dd
Gs, Gs, Gs, Ww, Dd, Dd, Gg^Vh, Gg^Vh, Gs^Ft, Dd, Ww, Ww, Ww, Ww, Ww, Ww, Ww, Dd, Dd, Gs^Ft, Dd, Gs^Ft, Gs, Re, Re, Gs, Dd, Gs, Gs, Gs, Gs, Gs^Ft, Gs^Ft, Gs^Ft, Dd, Dd, Dd, Dd, Ww, Ww, Ww, Dd
Rd, Dd, Dd, Ww, Ww, Ww, Ww, Ww, Ww, Ww, Ww, Ww, Ww, Dd, Ww, Ww, Ww, Dd, Dd, Dd, Dd, Gs, Gs, Gs, Re, Gs, Dd, Dd, Re, Re, Re, Gs, Gs, Gs^Ft, Dd, Dd, Dd, Dd, Ww, Ww, Ww, Ww
Rd, Dd, Dd, Ww, Ww, Ww, Ww, Ww, Ww, Ww, Ww, Ww, Dd, Ww, Dd^Vda, Dd, Dd, Dd, Dd, Dd^Vda, Dd, Gs^Ft, Gs, Gs, Gs, Re, Re, Re, Gs, Gs, Re, Gs, Gs, Hd, Gs^Ft, Dd, Dd, Dd, Ww, Ww, Wo, Ww
Rd, Dd, Dd, Ww, Ww, Ww, Wo, Ww, Ww, Ww, Wo, Ww, Ww, Ww, Dd, Dd, Dd, Dd, Dd, Dd, Dd, Dd, Gs^Ft, Dd, Dd, Dd, Gs, Gs, Gs, Gg^Vh, Ww, Rd, Rd, Hd, Dd, Dd, Dd, Dd^Vda, Ww, Ww, Wo, Ww
Rd, Dd, Ww, Ww, Ww, Ww, Wo, Ww, Ww, Ww, Ww, Ww, Ww, Ww, Dd, Dd, Dd, Gs, Gs, Dd, Dd, Dd, Dd, Dd, Dd, Dd, Gs^Ft, Gs, Gs, Ww, Ww, Ww, Dd^Vdt, Rd, Rd, Dd, Dd, Ww, Ww, Wo, Wo, Ww
Rd, Dd, Dd, Ww, Ww, Ww, Ww, Ww, Ww, Ww, Ww, Ww, Ww, Ww, Dd, Gs, Gs, Hd, Hd, Dd, Gs, Gs, Dd, Dd, Dd, Dd, Dd, Ww, Ww, Ww, Ww, Ww, Hd, Dd, Dd, Rd, Rd, Dd, Wo, Wo, Wo, Ww
Dd, Dd, Dd, Gs, Dd, Ww, Ww, Ww, Ww, Ww, Ww, Ww, Ww, Ww, Dd, Gs, Dd, Gs, Dd, Hd, Hd, Gs, Dd, Dd, Dd, Dd, Dd, Dd, Ww, Ww, Ww, Ww, Ww, Dd, Dd, Gs^Ft, Rd, Ww, Ww, Wo, Ww, Ww
Re, Dd, Gs^Ft, Gs, Gs, Dd, Ww, Ww, Ww, Ww, Ww, Ww, Ww, Ww, Ww, Dd, Dd, Dd, Dd, Hd, Hd, Gs, Gs, Dd, Dd, Dd, Dd, Dd, Ww, Ww, Ww, Ww, Md, Ch, Ch, Ch, Re, Ww, Ww, Ww, Ww, Ww
Re, Gs, Re, Re, Re, Gs, Gg^Vh, Gg^Vh, Gs, Dd, Ww, Ww, Ww, Ww, Ww, Dd, Dd, Dd, Dd, Hd, Hd, Dd, Dd, Dd, Dd, Dd, Dd, Dd^Vda, Ww, Md, Ww, Ww, Md, Ch, 2 Kh, Ch, Gs, Ww, Ww, Ww, Ww, Ww
Gs, Re, Gs^Ft, Dd, Gs, Re, Re, Re, Re, Gs, Ww, Ww, Ww, Ww, Ww, Ww, Dd, Dd, Dd, Dd, Dd, Dd, Dd, Dd, Dd, Dd, Dd, Dd, Hd, Md, Md, Ww, Ch, Ch, Ch, Dd, Gs^Ft, Ww, Ww, Ww, Ww, Ww
Gs^Ft, Gs^Ft, Dd, Dd, Dd, Dd, Gs^Ft, Gs^Ft, Gs^Ft, Rd, Rd, Dd, Ww, Ww, Ww, Ww, Ww, Dd, Dd, Dd, Dd, Gs, Dd, Dd, Dd, Dd, Dd, Dd, Hd, Hd, Hd, Hd, Ww, Dd, Dd, Gs^Ft, Gs, Ww, Ww, Ww, Ww, Ww
Re, Dd, Dd, Dd, Dd, Dd, Hd, Dd, Dd^Vda, Dd, Dd, Rd, Rd, Dd^Vda, Ww, Ww, Ww, Dd, Dd, Dd, Rd, Dd, Dd^Vda, Dd, Dd, Dd, Dd, Hd, Gs, Gs, Hd, Hd, Dd, Ww, Ww, Gs, Gs, Ww, Dd^Vda, Ww, Ww, Ww
Re, Dd, Dd, Dd, Dd, Hd, Hd, Dd, Dd, Dd, Dd, Gs^Ft, Gs, Re, Ww, Dd, Dd, Dd, Rd, Rd, Dd, Rd, Rd, Dd, Dd, Dd, Gs, Gs, Gs, Gs, Dd, Dd, Gs^Ft, Gg^Vh, Ww, Gs, Ww, Ww, Dd, Dd, Dd, Dd
Gs, Rd, Rd, Dd, Hd, Hd, Hd, Hd, Gs^Ft, Gs^Ft, Gs^Ft, Gs^Ft, Gs, Rd, Rd, Rd, Rd, Rd, Gs, Gs, Gs, Gs^Ft, Dd, Rd, Rd, Dd, Gs, Gs, Gs, Gs, Rd, Hd, Rd, Gs, Ww, Ww, Ww, Gs, Rd, Rd, Dd, Dd
