Hd, Dd, Dd, Dd, Ww, Ww, Ww, Wo, Ww, Ww, Dd, Gs, Gs^Ft, Gs, Gs, Hd, Hd, Hd, Hd, Hd, Gs^Ft, Dd, Dd, Dd, Dd, Dd, Dd, Ww, Ww, Dd, Dd, Dd, Dd, Dd, Dd, Gs^Ft, Dd, Dd, Dd, Dd, Dd, Dd
Hd, Hd, Dd, Dd, Dd, Ww, Ww, Wo, Ww, Ww, Ww, Gs, Gg^Vh, Gs, Gs, Gs, Gs, Gs, Hd, Hd, Hd, Dd, Dd^Vda, Dd, Dd, Dd, Dd, Dd^Vda, Dd, Ww, Dd, Dd, Dd, Dd^Vda, Dd, Hd, Hd, Hd, Dd, Gs^Ft, Gs^Ft, Gs^Ft
Hd, Hd, Dd, Dd, Dd, Ww, Ww, Wo, Ww, Ww, Ww, Gs, Gs, Gs, Gs, Gs, Gs, Gs, Gs, Gs, Hd, Hd, Dd, Dd, Dd, Dd, Dd, Dd, Dd, Dd, Dd, Dd, Gs^Ft, Gs^Ft, Gs^Ft, Hd, Md, Hd, Hd, Gs^Ft, Gs^Ft, Gs^Ft
Hd, Hd, Dd, Dd, Gs^Ft, Gg^Vh, Ww, Ww, Ww, Ww, Gs, Gs, Gs, Gs, Gs, Gs, Gs, Gs, Gs, Gs, Gs^Ft, Hd, Dd, Dd, Dd, Dd, Dd, Dd, Dd, Dd, Dd, Dd, Gs^Ft, Ch, Ch, Ch, Md, Md, Hd, Dd, Dd, Ww
Dd, Dd, Dd, Gs^Ft, Gs, Gs, Gs, Gg^Vh, Gs, Gs, Gs, Gs, Gs, Gs, Gs, Gs, Gs, Gs, Gs, Gs, Gs, Gs^Ft, Dd, Dd, Dd, Dd, Dd, Dd, Dd, Dd, Dd, Dd, Gs^Ft, Ch, 1 Kh, Ch, Hd, Hd, Hd, Gs, Gg^Vh, Ww
Dd, Dd, Dd, Hd, Gs, Gs, Gs, Gs, Gs, Gs, Gs, Gs, Dd, Gs, Gs, Gs, Gs, Gs, Gs, Gs, Gs, Gs^Ft, Dd, Dd, Dd, Dd, Dd, Dd, Dd, Dd, Dd, Gs^Ft, Ch, Ch, Ch, Hd, Hd, Hd, Gs, Gs, Dd, Ww
Gs^Ft, Gs^Ft, Hd, Hd, Hd, Hd, Gs^Ft, Gs, Gs, Gs, Gs^Ft, Gs, Gs, Gs, Gg^Vh, Gs, Gs, Gs, Gs, Gs, Gs, Dd, Dd, Dd, Dd, Dd, Dd, Dd, Dd, Dd, Gs^Ft, Gs^Ft, Gs^Ft, Gs^Ft, Dd, Rd, Dd, Dd, Gs, Gs, Dd, Dd
Gs, Gs, Gs, Hd, Hd, Hd, Hd, Gs^Ft, Gs, Gs^Ft, Dd, Dd, Gs^Ft, Gs, Gs, Gs, Gs, Gs, Gs, Gs, Gg^Vh, Ww, Dd, Dd, Dd, Dd, Dd^Vda, Hd, Hd, Hd, Hd, Gs, Gs^Ft, Gs^Ft, Gs^Ft, Rd, Dd, Dd, Dd, Dd, Dd, Dd
Gs, Gs, Gs, Gs, Hd, Hd, Gs, Dd, Dd, Dd, Dd, Dd, Dd, Gs^Ft, Gs, Gs, Gs, Gs, Gs, Gs, Gs^Ft, Ww, Dd, Dd, Dd, Dd, Dd, Hd, Hd, Hd, Hd, Hd, Gs^Ft, Dd, Dd, Rd, Dd, Dd, Dd, Dd, Dd, Dd
Ww, Gs^Ft, Gs, Gs, Gs, Gs, Gs^Ft, Dd, Dd^Vda, Dd, Dd, Dd, Dd, Gs^Ft, Hd, Hd, Hd, Gs, Gs, Gs, Gs^Ft, Ww, Dd, Dd, Dd, Dd, Dd, Hd, Gs^Ft, Hd, Hd, Gs, Gs^Ft, Dd, Rd, Rd, Dd, Dd, Dd, Dd, Dd, Dd
Ww, Gs^Ft, Gs^Ft, Gs, Gs^Ft, Dd, Dd, Dd, Dd, Dd, Dd, Dd, Gs^Ft, Hd, Hd, Md, Hd, Hd, Gs, Gs, Gs, Ww, Dd, Dd, Dd, Dd, Dd, Gs, Gs, Gs, Gs, Dd, Dd, Dd, Rd, Dd, Dd^Vda, Dd, Dd, Dd, Dd, Dd
Ww, Gs^Ft, Gs^Ft, Gs^Ft, Gs^Ft, Dd, Dd, Dd, Dd, Dd, Dd, Dd, Hd, Md, Ww, Ww, Ww, Md, Hd, Gs, Gs, Ww, Dd, Dd, Dd, Dd, Dd, Gs^Ft, Gs, Gs, Gs^Ft, Dd, Rd, Rd, Dd, Dd, Dd, Dd, Dd, Dd, Dd, Hd
Ww, Dd, Dd, Dd, Dd, Gs^Ft, Dd, Dd, Dd, Dd, Dd, Dd, Hd, Md, Ww, Ww, Ww, Ww, Dd, Gs^Ft, Gs^Ft, Ww, Dd, Dd, Dd, Dd, Dd, Dd, Gs^Ft, Gs, Gs, Dd, Rd, Dd^Vda, Ww, Dd, Dd, Dd, Gs^Ft, Dd, Dd, Hd
Dd, Dd, Dd, Dd, Dd, Dd, Dd, Dd, Dd, Gs^Ft, Dd, Dd, Hd, Hd, Md, Ww, Ww, Ww, Ww, Ww, Ww, Ww, Dd, Dd, Dd, Dd, Dd, Dd, Dd, Gs, Gs, Gs, Rd, Ww, Ww, Dd, Dd, Gs^Ft, Gs, Gs^Ft, Dd, Hd
Dd, Dd, Dd^Vda, Dd, Dd, Dd, Dd, Dd, Dd, Dd, Dd, Dd, Dd, Hd, Hd, Dd^Vdt, Ww, Ww, Ww, Ww, Dd, Dd, Dd, Dd, Dd, Dd, Dd, Gs^Ft, Gs^Ft, Gs, Dd, Gs, Rd, Ww, Dd^Vda, Dd, Dd, Dd, Dd, Gs^Ft, Gs^Ft, Hd
Dd, Dd, Dd, Dd, Dd, Dd, Dd, Dd, Gs^Ft, Gs^Ft, Gs, Dd, Dd, Dd, Gs, Gs^Ft, Ww, Gs, Gs^Ft, Dd, Dd, Dd, Dd, Dd, Dd, Dd, Dd, Gs^Ft, Gs, Gs, Re, Re, Dd, Dd, Dd, Dd, Dd, Dd, Dd, Gs^Ft, Gs, Hd
Dd, Dd, Gs^Ft, Dd, Dd, Dd, Dd, Gs^Ft, Gs, Gs, Gs, Gs^Ft, Gs^Ft, Dd, Dd, Dd, Gs^Ft, Gs^Ft, Gs, Gs, Gs, Gs^Ft, Gs^Ft, Gs^Ft, Dd, Dd, Dd, Gs, Re, Re, Gg^Vh, Gs, Dd, Gs, Dd, Dd, Dd, Dd, Dd, Gs^Ft, Gs, Gs^Ft
Dd, Dd, Gs^Ft, Gs^Ft, Dd, Dd, Gs^Ft, Gs^Ft, Gs^Vht, Gs, Gs^Ft, Dd, Dd, Dd, Dd, Dd, Gs^Ft, Gs^Ft, Gs, Gs, Re, Gg^Vh, Re, Gs^Ft, Dd, Dd, Rd, Rd, Dd, Gs^Ft, Dd, Ww, Ww, Gs^Ft, Dd, Dd, Dd, Hd, Hd, Gs^Ft, Gs, Gs
Dd, Dd, Gs, Gs, Gs^Ft, Dd, Dd, Gs, Gs^Ft, Gs^Ft, Dd, Dd, Dd, Dd, Dd, Dd, Gs^Ft, Gs, Re, Re, Gs, Re, Gs, Rd, Rd, Re, Dd, Dd, Dd, Dd, Ww, Ww, Ww, Dd, Dd, Dd, Dd^Vda, Hd, Hd, Gs, Gs, Gs
Dd, Dd, Gs, Gs, Gs, Gs, Gs, Gs, Gs, Gs, Dd, Dd, Dd, Gs^Ft, Gs^Ft, Gs^Ft, Re, Re, Gs, Hd, Hd, Hd, Hd, Dd, Dd, Gs, Gs, Ww, Ww, Ww, Ww, Ww, Ww, Dd, Dd, Dd, Dd, Dd, Gs, Gs, Gs, Gs
Dd, Dd, Gs, Gs, Gs, Gs, Gs, Gs, Gs, Gs, Gs^Ft, Dd, Gs^Ft, Gs, Gs^Ft, Gs, Re, Gg^Vh, Gs, Hd, Md, Hd, Hd, Hd, Dd, Gs, Gs, Ww, Dd, Dd, Ww, Ww, Ww, Ww, Dd^Vda, Dd, Dd, Gs^Ft, Gs, Gs, Gs, Gs
Dd, Dd^Vda, Gs, Gs, Gs, Gs, Gs, Gs, Gs, Gs, Gs^Ft, Dd, Gs^Ft, Gs, Gs, Gs, Re, Gs, Gs, Hd, Hd, Md, Hd, Hd, Dd^Vda, Dd, Dd, Dd, Dd, Dd, Ww, Ww, Ww, Ww, Ww, Dd, Gs^Ft, Gs^Ft, Gs, Gs, Gs, Gs
Dd, Gs^Ft, Gs, Gs, Gs, Gs, Gs, Gs^Ft, Gs^Ft, Dd, Dd, Dd, Hd, Gs, Gs, Gs, Re, Gs, Hd, Hd, Md, Md, Hd, Hd, Dd, Dd, Dd^Vda, Dd, Dd, Dd, Ww, Ww, Ww, Ww, Dd, Gs^Ft, Dd, Gs, Gs^Ft, Dd, Dd, Dd
Gs^Ft, Gs, Gs, Gs, Hd, Hd, Hd, Gs^Ft, Dd, Dd, Dd, Dd, Dd, Gs, Gs, Re, Gs^Ft, Gs^Ft, Dd, Hd, Hd, Md, Md, Md, Hd, Hd, Gs, Dd, Dd, Dd, Ww, Ww, Ww, Ww, Ww, Dd, Gs, Gs, Gs, Dd, Dd, Dd
Gs, Gs, Gs, Hd, Hd, Md, Hd, Hd, Dd, Dd^Vda, Dd, Dd, Dd, Gs^Ft, Re, Re, Gs^Ft, Dd, Dd, Hd, Hd, Md, Md, Md, Md, Hd, Gs, Gs, Gs^Ft, Gs^Ft, Ww, Ww, Ww, Ww, Dd, Dd, Dd, Gs, Dd, Dd, Dd, Dd
Gs, Gs, Hd, Hd, Md, Md, Md, Hd, Dd, Dd, Dd, Dd, Rd, Rd, Gs^Ft, Gs, Dd, Dd, Dd, Dd, Hd, Hd, Md, Md, Md, Md, Hd, Gs, Gs, Dd, Ww, Ww, Gs, Gs, Gs^Ft, Dd, Dd, Dd, Dd, Dd, Dd, Hd
Hd, Hd, Hd, Md, Md, Md, Md, Hd, Gs, Dd, Rd, Rd, Dd, Dd, Dd, Gs^Ft, Dd, Dd, Dd, Gs, Dd, Hd, Md, Md, Md, Md, Hd, Gs, Gs, Dd, Ww, Dd, Gs, Gs, Gs, Dd, Dd, Dd^Vda, Dd, Dd, Dd, Hd
Hd, Hd, Hd, Hd, Hd, Hd, Hd, Hd, Gs, Gs, Rd, Dd, Dd, Dd, Dd, Dd, Dd, Gs, Gg^Vh, Gs, Gs, Hd, Hd, Hd, Hd, Hd, Hd, Gs, Gs^Ft, Gs^Ft, Ww, Gs, Gs, Gs, Gs, Dd, Dd, Dd, Dd, Dd, Gs, Dd
Hd, Hd, Gs, Hd, Hd, Hd, Hd, Gs, Re, Rd, Dd, Dd, Dd, Dd, Dd, Dd, Dd, Ww, Gs, Gs, Gs, Dd, Dd, Dd, Dd, Gs^Ft, Gs^Ft, Gs, Gs^Ft, Dd, Gs^Ft, Gs^Ft, Gs, Gs, Gs, Dd, Dd, Dd, Dd, Dd, Dd, Gs
Hd, Gg^Vh, Gs, Hd, Hd, Gs, Gs, Re, Dd, Dd, Dd, Dd, Dd, Dd, Dd, Dd, Dd, Dd, Dd, Dd, Gs, Dd, Dd, Dd, Dd, Dd, Dd, Dd, Dd, Dd, Dd, Dd, Gg^Vh, Gs, Gs, Gs, Gs^Ft, Dd, Dd, Dd, Dd, Dd
Hd, Gs, Gs, Ch, Ch, Ch, Re, Re, Gs, Dd, Dd, Dd, Dd, Dd, Dd, Dd, Dd, Dd, Dd, Dd, Dd^Vda, Dd, Gs, Gs, Dd, Dd, Dd, Dd, Dd^Vda, Dd, Ww, Ww, Gs^Ft, Gs, Dd, Gs^Ft, Gs^Ft, Dd, Rd, Rd, Rd, Dd
Gs^Ft, Gs, Gs, Ch, 2 Kh, Ch, Gg^Vh, Ww, Ww, Dd, Gs^Ft, Dd, Dd, Dd, Dd, Dd, Dd, Dd, Dd, Dd, Dd, Dd, Gs, Gs, Gs, Dd, Dd, Dd, Dd, Ww, Ww, Dd, Dd, Dd, Dd, Dd, Rd, Rd, Dd, Dd, Dd, Rd
Dd, Gs, Ch, Ch, Ch, Gs^Ft, Dd, Ww, Ww, Ww, Dd, Dd, Gs, Gs, Gs^Ft, Gs^Ft, Gs^Ft, Gs, Gs, Gs^Ft, Dd, Dd, Dd, Gs, Gs, Gs, Dd, Dd, Dd, Dd, Gs^Ft, Dd, Dd, Dd, Dd, Dd, Rd, Dd, Dd, Dd^Vda, Ww, Ww
Gs^Ft, Gs, Gs^Ft, Gs^Ft, Gs^Ft, Ww, Ww, Ww, Ww, Ww, Ww, Gs^Ft, Gs, Gs, Gg^Vh, Gs, Gs, Gs, Gs, Gs^Ft, Dd, Dd, Dd, Gs, Hd, Hd, Hd, Dd, Dd, Dd, Gs^Ft, Dd, Dd, Dd, Dd, Re, Dd, Dd, Dd, Ww, Ww, Ww
Dd, Gs^Ft, Gs^Ft, Dd, Ww, Ww, Ww, Ww, Ww, Ww, Ww, Ww, Gs, Gs, Gs, Hd, Hd, Gs, Gs, Gs, Gs^Ft, Dd, Dd, Hd, Hd, Md, Md, Hd, Dd, Gs^Ft, Dd, Dd, Dd, Dd, Dd, Re, Gs, Dd, Dd, Ww, Ww, Ww
Dd, Dd, Ww, Ww, Ww, Ww, Wo, Wo, Wo, Ww, Ww, Ww, Dd, Gs, Gs, Gs, Gs, Gs, Gs^Ft, Gs^Ft, Gs^Vht, Dd, Dd, Hd, Hd, Md, Md, Hd, Hd, Gs^Ft, Dd, Hd, Dd, Dd, Dd, Rd, Rd, Dd, Dd, Ww, Ww, Ww
Dd, Dd, Dd, Ww, Ww, Ww, Wo, Wo, Wo, Wo, Ww, Ww, Ww, Gs, Gs, Gs, Gs, Gs, Gs^Ft, Dd, Gs^Ft, Gs^Ft, Dd, Dd, Hd, Hd, Hd, Hd, Hd, Hd, Hd, Hd, Hd, Gs^Ft, Dd, Dd, Rd, Dd, Dd, Dd, Gs, Gs
Dd, Gs^Ft, Gs, Dd, Ww, Ww, Ww, Ww, Ww, Ww, Ww, Ww, Ww, Ww, Ww, Gs, Gs, Gs^Ft, Rd, Dd, Gs^Ft, Gs^Ft, Dd, Dd, Dd^Vda, Hd, Hd, Hd, Hd, Hd, Re, Re, Re, Gs, Re, Rd, Dd, Dd, Dd, Gs^Ft, Dd, Gs^Ft
Dd, Dd, Gs, Gg^Vh, Gs, Ww, Ww, Ww, Ww, Ww, Ww, Ww, Ww, Ww, Ww, Ww, Re, Rd, Dd, Rd, Rd, Rd, Rd, Gs^Ft, Rd, Hd, Hd, Hd, Hd, Gs, Re, Gg^Vh, Gs, Re, Gs^Ft, Rd, Dd, Dd, Dd, Gs^Ft, Rd, Rd
Gs, Gs, Gs, Gs, Gs, Dd, Ww, Ww, Ww, Dd^Vda, Ww, Ww, Wo, Wo, Ww, Ch, Rd, Dd, Rd, Dd, Rd, Rd, Re, Re, Re, Rd, Rd, Dd, Re, Re, Gs, Gs, Gs, Gs, Gs^Ft, Rd, Rd, Rd, Rd, Rd, Dd, Hd
Gs, Gs, Gs, Gs, Gs, Gs, Dd, Dd, Ww, Ww, Ww, Ww, Wo, Ww, Ww^Bw/, Ww^Bw/, Ww, Rd, Dd, Rd, Dd, Hd, Gs^Ft, Hd, Gs, Rd, Re, Re, Gs, Gs, Gs, Gs, Gs, Gs, Gs^Ft, Dd, Dd, Dd, Dd, Dd, Dd, Hd
Gs, Gs, Gs, Gs, Gs, Gs, Gs, Ww, Ww, Ww, Ww, Ww, Wo, Ww, Ww, Ww, Ww, Ww, Dd, Dd, Dd, Dd, Hd, Hd, Hd, Gs, Gs, Gs, Gs, Gs, Gs, Gs, Gs, Gs, Dd, Hd, Hd, Hd, Hd, Dd, Dd, Dd
