Ss, Ss, Gg, Gg, Hh, Mm, Mm, Ww, Ww, Ww, Gg, Gg, Ww, Gg, Ww, Ww, Ww, Ww, Ss, Ss, Ss, Ss, Ss, Ss, Ss, Hh, Mm, Mm, Mm, Mm, Mm, Hh, Ss, Ss, Ss, Ss, Ss, Ss, Ss, Ss, Ss, Ss
Ss, Ss, Ss^Vhs, Ss, Hh, Mm, Mm, Mm, Mm, Hh, Gg, Gg, Gg, Ww, Ww, Ww, Wo, Ww, Gs^Fp, Ss, Ss, Ss, Ss, Ss, Ss, Hh, Hh, Mm, Hh, Hh, Hh, Ss, Ss, Ss, Ss, Ss, Ss, Ss, Ss, Gg, Ss, Ss
Ss, Ss, Ss, Ss, Hh, Mm, Mm, Mm, Mm, Hh, Gg, Ss, Ss, Ww, Ww, Ww, Wo, Ww, Ss, Ss, Ss, Ss, Ss, Ss, Ss, Ss^Vhs, Ss, Ss, Hh, Ss, Ss, Ss, Ss, Ss, Ss, Ss, Ss, Ss, Gg, Gg, Ss, Hh
Gs^Fp, Ss, Ss, Ss, Hh, Mm, Mm, Mm, Mm, Hh, Gg, Ss, Ss, Ww, Ww, Ww, Wo, Ww, Ss, Ss, Ss, Ss, Ss, Ss, Ss, Ss, Ss, Ss, Ss, Ss, Gs^Fp, Gs^Fp, Ss^Vhs, Ss, Ss, Ch, Ch, Ch, Ss, Gg, Hh, Hh
Gs^Fp, Ss, Ss, Ss, Hh, Mm, Mm, Hh, Hh, Gg, Gg, Gg, Gg^Ve, Ww, Ww, Ww, Ww, Ww, Ss, Ss, Gg, Gg, Gg, Ss, Ss, Ss, Ss, Ss, Ss, Ss, Gs^Fp, Gs^Fp, Ww, Gs^Fp, Ss, Ch, 1 Kh, Ch, Ss, Hh, Hh, Hh
Gs^Fp, Ss, Ss, Ss, Hh, Hh, Hh, Gg, Gg, Gg, Gg, Gg, Gg, Gg, Ww, Ww, Ww, Ww, Ss, Ss, Gg, Gg, Gg, Gg, Gg, Gg, Gg, Ss, Ss, Ss, Ss, Ss, Ss, Ss, Ch, Ch, Ch, Ss, Gg, Hh, Hh, Hh
Ss, Ss, Ss, Hh, Hh, Hh, Hh, Gg, Gg, Gg, Gg, Gg, Gg, Ss, Ss, Ss, Ss, Gg^Ve, Ss, Ww, Gg, Ww, Gg, Gg, Gg, Gg, Gg, Gg, Ss, Ss, Ss, Ss, Ss, Ss, Ss, Ss, Ww^Bw|, Ss, Hh, Hh, Hh, Hh
Ss, Hh, Hh, Mm, Mm, Mm, Hh, Ss, Ss, Ss, Ss, Gg, Ss, Ss, Ss, Ss, Ss, Ss, Ss, Ss, Ww, Ww, Gg, Gg, Gg, Gg, Gg, Ss, Ss, Ss, Ss, Ss, Ss, Ss, Ss, Ss, Re, Hh, Hh, Hh, Gg, Ss
Ss, Hh, Mm, Mm, Mm, Mm, Hh, Gg, Ss, Ss, Ss, Gg, Ss, Ss, Ss, Ss, Ss, Ss, Ss, Gg, Ww, Gg^Ve, Gg, Gg, Gg, Gg, Ss, Ss, Ss, Ss, Ss, Ss, Ss, Ss, Ss, Gg, Re, Hh, Hh, Gg, Gg, Ss
Ss, Hh, Hh, Mm, Mm, Hh, Hh, Gg, Gg, Gg, Gg, Gg, Gg, Ss, Ss, Ss, Gs^Fp, Ss, Ss, Gg, Gg, Gg, Gg, Gg, Ss, Ss, Ss, Ss, Ss, Gg, Ss, Gg, Gg, Gg, Gg, Gg, Re, Ss, Ss, Ss, Ss, Ss
Ss, Ss, Hh, Hh, Hh, Hh, Hh, Hh, Gg, Gg, Gg, Gg, Gg, Ss, Ss, Gs^Fp, Gs^Fp, Ss, Ss, Ss, Gg, Ss, Ss, Ss, Ss, Ss, Ss, Ss, Ss, Gg, Re, Re, Re, Re, Re, Re, Gg, Ss, Ss, Ss, Gs^Fp, Ss
Ss, Ss, Ss, Hh, Hh, Mm, Hh, Hh, Hh, Hh, Hh, Hh, Gg, Ss, Ss, Gs^Fp, Gs^Fp, Ss, Ss, Gg, Gg, Ss, Ss, Ss, Ss, Ss, Ss^Vhs, Ss, Ss, Ss, Re, Ss^Vhs, Ss, Ss, Re, Gg, Gg, Ss, Gs^Fp, Gs^Fp, Ss, Ss
Ss, Gs^Fp, Gs^Fp, Ss, Ss, Hh, Hh, Hh, Hh, Hh, Hh, Hh, Gg, Ss, Ss, Ss, Ss, Ss, Ss, Gg, Gg, Ss, Gs^Fp, Gs^Fp, Ss, Hh, Re, Re, Re, Ww^Bw/, Ss, Ss, Ss, Ss, Gg, Re, Re, Ch, Re, Re, Re, Ss
Ww, Gs^Fp, Ss, Gs^Fp, Gs^Fp, Ss, Ss^Vhs, Hh, Hh, Mm, Hh, Hh, Gg, Gg, Ss, Ss, Ss, Ss, Gg, Gg, Gg, Ss, Gs^Fp, Gs^Fp, Ss, Ss, Re, Mm, Hh, Hh, Hh, Hh, Hh, Hh, Gg, Gg, Gg, Ss, Ss, Ss^Vhs, Ww^Bw|, Ww
Ss, Ww, Ww, Ss, Ss, Ss, Hh, Hh, Mm, Mm, Mm, Hh, Gg, Gg, Ss, Ss, Ss^Vhs, Gg, Gg, Gg, Ww, Ss, Gs^Fp, Gs^Fp, Re, Ww^Bw/, Hh, Hh, Mm, Mm, Mm, Mm, Hh, Hh, Ss, Gg, Gg, Ss, Ss, Ss, Re, Ww
Ss, Ww, Ww, Ss, Ss, Gg, Hh, Mm, Mm, Mm, Mm, Ss, Gg, Gg, Ss, Ww, Ww, Ww, Gg, Gg, Gg^Ve, Ww, Ww^Bw/, Ww^Bw/, Ss, Ss, Hh, Mm, Mm, Mm, Mm, Mm, Mm, Hh, Ss^Vhs, Gg, Gg, Gg, Ss, Ss, Ww, Ww
Gg, Ss^Vhs, Ss, Gg, Gg, Mm, Mm, Mm, Mm, Mm, Mm, Hh, Ss, Ss, Gg, Ww, Ww, Gg, Gg, Gg, Gg, Re, Ww, Ss, Ss, Ss, Ss, Hh, Mm, Mm, Mm, Mm, Mm, Hh, Hh, Ss, Gg, Gg, Ss, Gs^Fp, Ww, Ww
Gg, Ss, Gg, Gg, Mm, Mm, Mm, Mm, Mm, Mm, Mm, Ss, Ss, Ss, Ww, Ww, Ww, Gg, Gg, Gg, Re, Re, Ss, Gg, Gg, Gg, Gg, Hh, Mm, Mm, Mm, Mm, Mm, Mm, Hh, Ss, Ss, Ss, Ss, Gs^Fp, Gs^Fp, Ww
Gg, Gg, Gg, Hh, Mm, Mm, Mm, Mm, Mm, Mm, Mm, Hh, Ss, Ss, Ww, Wo, Ww, Ss, Gg, Gg, Re, Ss, Ss, Gg, Gg, Gg, Gg^Ve, Gg, Mm, Mm, Mm, Mm, Mm, Mm, Mm, Ss, Ss, Ss, Ss, Ss, Gs^Fp, Gs^Fp
Gg, Gg, Gg, Hh, Mm, Mm, Mm, Mm, Mm, Mm, Mm, Hh, Ss, Ss, Ww, Ww, Gg, Gg, Gg, Gg, Gg, Re, Ss, Gg, Gg, Gg, Gg, Gg, Mm, Mm, Mm, Mm, Mm, Mm, Hh, Ss, Ss, Ss, Ss, Ss, Ss, Gs^Fp
Ss, Gg, Gg, Gg, Hh, Mm, Mm, Mm, Mm, Mm, Mm, Hh, Gg, Gg, Ww, Gg^Ve, Ss, Ss, Ss, Gg, Re, Re, Gg, Ss, Ss, Ss, Gg, Gg, Hh, Mm, Mm, Mm, Mm, Mm, Hh, Ss, Ss, Ss, Ss, Ss, Ss, Ss
Ww, Ss, Gg^Ve, Gg, Gg, Hh, Mm^Vhh, Mm, Mm, Mm, Mm, Hh, Gg, Gg, Gg, Gg, Ss, Ss, Ss, Re, Gg, Gg, Ss, Ss, Ss, Ss, Ss, Gg, Hh, Mm, Mm, Mm, Mm, Hh, Gs^Fp, Ss, Ss, Ss, Ss, Hh, Hh, Hh
Ww, Ww, Ww, Ss, Ss, Hh, Hh, Mm, Mm, Mm, Mm, Hh, Gg, Gg, Gg, Ss, Ss, Ss, Ss, Re, Gg, Gg, Ss, Ss, Ss, Ss, Gg, Gg, Hh, Mm, Mm, Hh, Hh, Gs^Fp, Gg^Ve, Ss, Ss, Gs^Fp, Gs^Fp, Hh, Hh, Mm
Ww, Ww, Gs^Fp, Gs^Fp, Ss, Hh, Mm, Mm, Mm, Mm, Mm, Hh, Gg, Gg, Ss, Ss, Ss, Ss, Gg, Re, Gg, Gg, Ss^Vhs, Ww, Ww, Gg, Gg^Ve, Gg, Gg, Hh, Hh, Hh, Gs^Fp, Ss, Gs^Fp, Gs^Fp, Gs^Fp, Gg^Ve, Gs^Fp, Hh, Mm, Mm
Wo, Ww, Ww, Gs^Fp, Ss, Hh, Mm, Hh, Hh, Hh, Hh, Hh, Gg, Gg, Ss, Gg, Gg, Gg, Re, Re, Gg, Gg, Gg, Ww, Ww, Gg, Gg, Gg, Gg, Ss, Ss, Ss, Ss, Ss, Ss, Ss, Ss, Ss, Hh, Hh, Mm, Mm
Wo, Ww, Gs^Fp, Gs^Fp, Gs^Fp, Gs^Fp, Hh, Hh, Hh, Hh, Gg, Gg, Gg, Gg, Re, Re, Re, Re, Re, Gg, Gg, Gg, Gg, Gg, Gg, Gg, Gg, Gg, Gg, Ss, Ss, Ss, Ss, Ss, Ss, Ss, Ss, Ss, Hh, Mm, Mm, Mm
Ww, Ww, Gs^Fp, Gs^Fp, Gs^Fp, Ss, Ss, Hh, Hh, Gg, Gg, Gg, Re, Re, Gg, Gg, Ss, Ss^Vhs, Re, Gg, Gg, Gg, Gg, Gg, Ss, Ss, Ss, Gg, Gg, Ss, Ss, Ss, Ss, Ss, Gg, Hh, Hh, Ss, Hh, Hh, Mm, Mm
Ww, Gs^Fp, Gs^Fp, Gs^Fp, Ss, Ss, Ss, Hh, Hh, Gg, Gg, Gg^Ve, Re, Gg, Gg, Ss, Ss, Ss, Re, Gg^Ve, Gg, Gg, Gg, Gg, Ss, Ss, Ss, Ss, Ss, Ss, Ss, Ss, Ss, Gg, Gg, Hh, Hh, Ss, Ss^Vhs, Hh, Mm, Mm
Ww, Gg^Ve, Gs^Fp, Ss, Ss, Ss, Ss, Hh, Hh, Hh, Re, Re, Gg, Gg, Gg, Ss, Ss, Gg, Gg, Re, Re, Gg, Gg, Ss, Ss, Ss, Ss, Ss, Ss, Ss, Ss, Ss, Ss, Gg, Gg, Gg, Ss, Ss, Ss, Hh, Mm, Mm
Ww, Gs^Fp, Ss, Ss, Ss, Ss, Hh, Hh, Re, Re, Gg, Gg, Gg, Gg, Gg, Gg, Gg, Gg, Hh, Gg, Gg, Re, Gg, Ss, Ss, Ss, Gs^Fp, Gs^Fp, Ss, Ss, Ss, Ss, Ss, Gg, Gg, Gg, Gg, Ss, Ss, Ss, Hh, Mm
Ss, Gs^Fp, Ss, Ss, Hh, Hh, Ss, Ch, Hh, Hh, Hh, Hh, Hh, Gg, Hh, Hh, Hh, Hh, Gg, Gg, Gg, Re, Gg, Ss, Ss, Gs^Fp, Gs^Fp, Gs^Fp, Ss, Ss, Ss^Vhs, Ss, Ss, Gg, Gg, Gg, Gg, Gg, Ss, Gg, Hh, Hh
Ss, Ss, Ss, Ss, Hh, Hh, Re, Re, Hh, Mm, Mm, Mm, Mm, Mm, Hh, Hh, Mm, Hh, Hh, Gg, Gg, Re, Ww, Ww, Gs^Fp, Gs^Fp, Gs^Fp, Gs^Fp, Ss, Ss, Ss, Ss, Ss, Ss, Gg, Gg, Gg, Gg, Gg, Gg, Gg, Hh
Ss, Gg, Gg, Ss, Ss, Gg, Re, Gg, Hh, Mm, Mm, Mm, Mm, Mm, Mm, Mm, Mm, Hh, Gg, Gg, Gg, Re, Ww, Ww, Ww, Gg^Ve, Gs^Fp, Ss, Ss, Ss, Hh, Ss, Ss, Ss, Gg, Gg, Gg, Gg, Gg, Gg, Gg, Ss
Gg, Gg, Gg^Ve, Gg, Gg, Ss, Re, Gg, Hh, Mm, Mm, Mm, Mm, Mm, Mm, Mm, Hh, Hh, Ss, Gg, Gg, Re, Ww^Bw\, Ww, Ww, Ww, Gs^Fp, Gs^Fp, Ss, Hh, Hh, Hh, Ss, Ss, Ss, Ss, Ww, Ww, Gg^Ve, Ss, Ss, Ss
Ss, Gg, Re, Re, Re, Re, Gg, Gg, Hh, Mm, Ww, Mm, Mm, Mm, Mm, Mm, Hh, Hh, Ss, Ss, Ss, Ss, Ww, Ch, Ww, Ss, Ss, Ss, Ss, Hh, Mm, Hh, Hh, Ss, Gs^Fp, Ss, Ww, Ww, Ww, Ss, Ss, Ss
Ss, Ss, Ww^Bw|, Ch, Ch, Ch, Ss, Gg, Gg, Hh, Ww, Ww, Mm, Mm, Mm, Mm, Hh, Ss^Vhs, Ss, Ss, Ss, Ss, Gg, Ww^Bw|, Ww, Ss, Ss, Ss, Hh, Mm, Mm, Hh, Hh, Ss, Gs^Fp, Ss, Ww, Ww, Ww, Ww, Ss, Ss
Ss, Ss, Ch, Ch, 2 Kh, Ch, Ss, Gg, Gg, Gg^Ve, Ww, Ww, Ww, Ww, Ww, Mm, Hh, Ss, Ss, Gs^Fp, Ss, Ss, Gg, Re, Gg, Gg, Gg, Hh, Mm, Mm, Mm, Mm, Hh, Ss, Gs^Fp, Gs^Fp, Ww, Ww, Ww, Ww, Ww, Ss
Re, Ww^Bw/, Ch, Ch, Ch, Ss, Ss, Gg, Ww, Ww, Hh, Mm, Mm, Mm, Ww, Hh, Hh, Ss, Ss, Gs^Fp, Ss, Ss, Gg, Re, Re, Ss^Vhs, Gg, Mm, Mm, Mm, Mm, Hh, Ss, Ss, Gs^Fp, Ss^Vhs, Ww, Ww, Wo, Ww, Ww, Ww
Gs^Fp, Ss, Ss, Ss, Ss, Gs^Fp, Ww, Ss, Ww, Ww, Gg, Hh, Hh, Hh, Ww, Ww, Hh, Ss, Ss, Ss, Ss, Ss, Gg, Gg, Ch, Ss, Ss, Hh, Mm, Mm, Mm, Ss, Ss, Ss, Ss, Ww, Ww, Ww, Ww, Ww, Ww, Ww
Ss, Ss, Ss, Ss, Ss, Ss, Ww, Ww, Ss, Ss, Gg, Ss, Ss, Ss, Ss, Ww, Ww, Ss, Ww, Ss^Vhs, Ss, Ss, Ss, Ss, Ss, Ww^Bw\, Ww^Bw\, Hh, Hh, Hh, Ss, Ss, Ss, Ss, Ss, Ww, Ww, Ww, Ww, Ww, Ww, Ww
Ss, Gg, Gg, Gg, Gg^Ve, Ww, Ss, Ss^Vhs, Ss, Ss, Gg, Ss, Gg, Gg, Ss, Ss^Vhs, Ww, Ww, Ww, Ww, Ww, Gs^Fp, Ww, Gs^Fp, Gs^Fp, Gs^Fp, Ss, Ww^Bw\, Re, Gg, Ss, Ss, Gg, Ww, Ww, Ss, Ss, Ww, Ww, Ww, Ww, Ww
Gg, Gg, Gg, Gg, Ww, Ww, Gg, Ss, Ss, Ss, Ss, Gg, Gg, Gg, Gg, Ss, Ss, Ww, Ss, Ss, Gs^Fp, Ww, Ww, Ww, Gs^Fp, Gs^Fp, Gs^Fp, Ss, Re, Gg, Gg, Ss, Ww, Ww, Ww, Ww, Gg, Gg, Gg, Gg, Gg, Ww
