Ss, Ss, Ss, Ss, Ss, Ss, Gg, Gg, Gg, Gg, Gg, Ss, Ww, Ss, Ss, Ss, Ss, Ss, Gs^Fp, Gs^Fp, Ww, Ww, Gs^Fp, Gs^Fp, Gs^Fp, Ss, Ww^Bw/, Ww^Bw/, Ss, Re, Hh, Ww, Ww, Mm, Ww, Ww, Gg, Gg, Gg, Gg, Gg, Gg
Ss, Ss, Hh, Hh, Hh, Gg, Gg, Gg, Gg, Gg, Gg, Gg, Ww, Ss, Ss, Ss, Ss, Gs^Fp, Gs^Fp, Gs^Fp, Ww, Ww, Gs^Fp, Gs^Fp, Re, Re, Ss, Ss, Ss, Hh, Mm, Mm, Mm, Mm, Ww, Ww, Ss, Ss, Gg, Gg, Gg, Gg
Ss, Ss, Hh, Mm, Hh, Hh, Gg^Ve, Gg, Gg, Gg, Gg, Gg, Ww, Ss, Ss, Ss, Gs^Fp, Gs^Fp, Gs^Fp, Ww, Ww, Ww, Ss, Re, Gg^Ve, Gs^Fp, Ss, Ss, Ss, Hh, Mm, Mm, Mm, Mm, Mm, Mm, Hh, Ss, Ss, Ss, Gg, Gg
Ww, Ss, Ww, Mm, Mm, Mm, Ww, Gg, Ww, Gg, Gg, Ww, Ch, Ch, Ch, Ss, Ss, Gs^Fp, Gs^Fp, Gg^Ve, Gs^Fp, Ss, Ch, Re, Gs^Fp, Gs^Fp, Ss, Ss, Ss, Hh, Mm, Mm, Mm, Mm, Mm, Hh, Ww, Hh, Ww, Ss, Ss, Gg
Ss, Ww, Ww, Mm, Ww, Ww, Ww, Ww, Gg^Ve, Ww, Ww, Ww, Ch, 1 Kh, Ch, Ss, Ss, Ss, Gs^Fp, Gs^Fp, Gs^Fp, Gs^Fp, Re, Ss, Ss, Ss, Ss, Ss, Ss, Gg, Hh, Mm, Mm, Mm, Mm, Mm, Ww, Ww, Ww, Ss^Vhs, Ww, Ww
Ss, Hh, Mm, Ww, Mm, Ww, Hh, Ss, Gg, Ww, Gg, Ch, Ch, Ch, Ss, Ss, Ss, Ss, Gs^Fp, Gs^Fp, Gs^Fp, Re, Ss, Ss, Ss, Ss, Ss, Ss, Ss, Ss, Ss, Gg, Gg, Hh, Hh, Ww, Hh, Hh, Hh, Ww, Ss, Ww
Ss, Ss, Hh, Mm, Mm, Hh, Hh, Gg, Gg, Gg, Gg, Gg, Re, Ss, Ss^Vhs, Ss, Ss, Ss, Ss, Gs^Fp, Gs^Fp, Ww^Bw|, Ss, Ss, Ss, Ss, Ss, Ss, Ss, Ss, Ss, Gg, Ss, Ss, Ww, Ww, Hh, Hh, Hh, Ww, Ww, Ww
Ss, Ss^Vhs, Ss, Hh, Hh, Hh, Gg, Gg, Gg, Gg, Gg, Gg, Ss, Re, Gg, Gg, Ss, Ss, Ss, Gs^Fp, Ss, Re, Ss, Ss, Ss, Ss, Ss, Ss, Ss, Ss, Ss, Ss, Ss, Ss^Vhs, Ww, Ss, Ss, Ss, Ss, Ss, Ww, Gg
Ss, Ss, Ss, Ss, Ss, Gg, Gg, Gg, Gg, Ss, Gg, Gg, Gg, Re, Gg, Gg, Ss, Ss, Ss, Ss, Re, Re, Gs^Fp, Ss, Ss, Ss, Ss, Ss, Ss, Ss, Ss, Ss, Ss, Ww, Ww, Ss, Ss, Ss, Hh, Ss, Ww, Gg
Ss, Ss, Ss, Ss, Ss, Hh, Gg, Gg, Ss, Gg, Gg, Gg, Gg, Re, Gg, Gg, Gg, Ss, Gg, Re, Ss, Ss, Ss, Gs^Fp, Ss, Ss, Ss^Vhs, Ss, Ss, Ss, Ss, Ss, Gg, Ww, Ss, Ss, Ss, Hh, Hh, Gg, Gg, Gg
Ss, Ss, Ss, Ss, Ss, Ss, Ss, Ss, Gg, Gg, Gg, Ss, Gg, Re, Re, Gg, Gg, Gg, Re, Re, Gg, Ss, Ss, Ss, Ss, Ss, Ss, Ss, Ss, Ss, Ss, Gg, Gg, Ww, Ss, Ss, Hh, Hh, Hh, Gg, Gg, Gg
Ww, Ss, Gg, Ss, Ss, Ss, Ss, Gg, Gg, Gg, Ww, Ww, Ss^Vhs, Ss, Ss, Re, Re, Re, Gg, Gg, Gg, Gg, Gg, Ss, Ss, Ss, Ss, Ss, Ss, Ss, Gg, Gg, Gg^Ve, Ww, Ss, Gg, Gg, Hh, Gg, Gg, Gg, Ss
Ww, Ww, Ww, Hh, Ss, Ss, Ss, Ss, Gg, Gg^Ve, Ww, Ww, Ss, Ss, Ss, Gg, Re, Gg, Gg, Gg, Gg, Gg, Hh, Hh, Mm, Hh, Ss, Ss, Ss, Ss, Ss, Ss, Ww, Ww, Ss, Ss, Ss^Vhs, Ss, Gg, Gg, Ss, Ss
Ss, Ww, Ww, Mm, Mm, Mm, Ww, Ss, Ww, Ww, Ww, Ss, Ss, Ss, Ss, Gg, Re, Gg, Hh, Hh, Hh, Mm, Ww, Ww, Mm, Mm, Hh, Ss, Ss, Ss, Ss, Ss, Ww, Ww, Ss, Ss, Ss, Ss, Ss, Ss, Ss, Ss
Ss, Hh, Mm, Ww, Ww, Ww, Mm, Ww, Ww, Ww, Ww, Ss, Ss, Ss, Ss, Ss, Hh, Re, Re, Mm, Mm, Ww, Ww^Vm, Ww, Mm, Mm, Hh, Ss, Ss, Ss, Ss, Ss, Ww, Ss, Ss, Ss, Ss, Ss, Ss, Ss, Ss, Ss
Ss, Hh, Hh, Hh, Mm, Mm, Hh, Hh, Ww, Ww, Ww, Ss, Ss, Ss, Ss, Hh, Mm, Mm, Mm, Re, Mm, Mm, Ww, Ww, Hh, Hh, Ss, Ss, Ss, Ss, Gs^Fp, Ss, Ww, Ww, Ss, Ss, Ss, Ss, Ss, Ss, Ss, Ss
Ss, Ss, Hh, Hh, Mm, Hh, Hh, Hh, Ss, Ss, Ss, Gg, Ss, Ss, Ss, Hh, Mm, Mm, Mm, Re, Hh, Ss, Ss, Ww, Ww, Ss, Ss, Ss, Gs^Fp, Gs^Fp, Ss, Ss, Ww, Ss, Ss, Ss, Ss, Ss, Ww, Ww, Ss, Ss
Ss, Ss, Ss, Hh, Hh, Hh, Hh, Ss, Ss, Ss, Gg, Gg, Gg, Ss, Ss, Ss, Hh, Mm, Mm, Re, Hh, Ss, Ss, Ss, Ww, Ss, Ss, Gs^Fp, Gg^Ve, Gs^Fp, Gs^Fp, Ww, Ww, Ss, Ss, Ww, Ww, Ww, Ww, Ww, Ss, Gg
Ss, Ss, Ss, Ss, Ss, Ss, Ss, Ss, Ss, Ss, Gg, Gg, Gg, Ss, Ss, Ss, Ss, Mm, Mm, Re, Ss, Ss, Ss, Ss, Ww, Ww, Ss, Gs^Fp, Gs^Fp, Gs^Fp, Gs^Fp, Ww, Ww, Ww, Ww, Ww, Ss, Ww, Ss, Gg^Ve, Ss, Gg
Ss, Ss, Ss, Ss, Ss, Ss, Ss, Ss^Vhs, Ss, Hh, Gg, Gg, Gg, Gg, Ss, Ss, Ss, Ss, Hh, Re, Ss, Ss, Ss, Ss, Ss^Vhs, Ww, Ss, Ss, Ss, Gs^Fp, Gg^Ve, Ww, Gs^Fp, Ss, Ww, Ww, Ss, Ss, Ss, Gg, Gg, Gg
Ss, Ss, Ss, Ss, Ss, Ss, Ss, Ss, Gg, Gg, Gg, Gg, Gg, Gg, Ss, Ss, Ss, Ss, Re, Re, Ss, Ss, Ss, Ww, Ww, Ww, Ww, Ss, Ss, Gs^Fp, Gs^Fp, Ww, Ss, Ss, Ss, Ss, Ss, Ss, Ss, Gg, Gg, Gg
Ss, Ss, Ss, Gs^Fp, Ss, Ss, Ss, Gg, Gg, Gg, Gg, Gg, Gg, Gg, Ss, Ss, Ss, Ss^Vhs, Re, Gg, Ss, Ss, Ss, Ss, Ww, Ww, Ss, Ss, Ss, Gs^Fp, Gs^Fp, Ww, Ss, Ss, Ss, Ss, Ss, Ss, Ss, Gg, Gg, Gg
Ss, Ss, Gs^Fp, Gg^Ve, Gs^Fp, Gs^Fp, Ss, Ss, Gg, Gg, Gg, Gg, Gg, Ss, Ss, Ss, Ss, Ss, Re, Ss, Ss, Ss, Ss, Ss, Ww, Ss, Ww, Ww, Ww, Ss, Ww, Ww, Ss, Ss, Ss, Ss, Ss, Ss, Gg, Gg, Gg, Gg
Ss, Ss, Gs^Fp, Gs^Fp, Gs^Fp, Gs^Fp, Ss, Ss, Ss, Ss, Ss, Ss, Ss, Ss, Ss, Ss, Ss, Ss, Ch, Ss, Ss, Ww, Ww, Ww, Ss, Ww, Ww, Ww, Ss, Ww, Ss, Ww, Ss, Ss, Ss, Ss, Gg, Gg, Gg, Gg, Gg, Gg
Ss, Gs^Fp, Gs^Fp, Gs^Fp, Gs^Fp, Gs^Fp, Ss, Ss, Ss, Ss, Ss, Ss, Ss, Ss, Ss, Ss, Ss, Ch, Ss, Ss, Ww, Ww, Wo, Wo, Ww, Ww, Ww, Gg^Ve, Ss, Ss, Ss, Ss, Ss, Ss, Ss, Gg, Gg, Gg, Re, Re, Re, Ss
Gs^Fp, Gs^Fp, Gs^Fp, Gs^Fp, Gs^Fp, Ss, Ss, Ss, Ss, Ss, Ss, Ss, Ss, Gg, Gg, Gg, Gg, Re, Re, Ss, Gs^Fp, Ww, Ww, Ww, Ww, Wo, Ww, Ww, Gg, Ss, Ss, Ss, Gg, Gg, Re, Re, Re, Re, Ss, Ss^Vhs, Re, Ss
Ss, Ss, Ss, Ss, Ss, Ss, Gg, Ss, Ss, Ss, Ss, Ss, Ss, Ss, Gg, Gg, Gg, Gg^Ve, Re, Gg, Ss, Ww, Ww, Ww, Ww, Ww, Wo, Ww, Gg, Gg, Ss, Gg, Gg, Re, Gg, Hh, Gg, Ss, Ss, Hh, Ss, Ss
Ss, Ss, Ss, Ss, Ss, Ss, Gg, Gg, Ss, Ss, Ss, Gs^Fp, Gs^Fp, Ss, Gg, Gg, Gg, Gg, Re, Gg, Ss, Ss, Ss, Ss^Vhs, Ww, Ww, Ww, Ww, Gg, Ss, Gg, Gg, Gg, Re, Hh, Hh, Hh, Hh, Hh, Hh, Hh, Hh
Ww, Ww, Ww, Ww, Ww, Gg, Gg, Gg, Re, Gg, Ss^Vhs, Ss, Ss, Gg, Ss, Gg, Gg, Gg, Re, Gg, Re, Ss, Ss, Ss, Gg, Gg, Ww, Ww, Ww^Bw/, Re, Re, Ss, Gg^Ve, Re, Gg, Hh, Mm, Mm, Mm, Mm, Mm, Hh
Ww, Ww, Ss, Ss, Ch, Gg^Ve, Re, Re, Gg, Re, Re, Re, Re, Re, Re, Re, Re, Gg, Re, Re, Gg, Re, Ww^Bw\, Gg, Re, Gg, Re, Ww^Bw/, Ww, Ww, Gg, Re, Re, Re, Gg, Hh, Hh, Mm, Mm, Mm, Mm, Hh
Ss, Ss, Gg, Re, Ww, Re, Gg, Gg, Ss, Gg, Gg, Gg, Ss, Ss, Ss, Hh, Ss, Re, Ss, Gg, Gg, Gg, Gg, Re, Gg, Re, Ww, Ww, Ww, Ww, Ww, Gg, Gg, Re, Gg, Hh, Hh^Vhh, Hh, Mm, Mm, Mm, Mm
Ss, Ss, Gg, Re, Ww, Ss, Ss, Ss, Ss, Ss, Ss, Ss, Ss, Ss, Mm, Mm, Mm, Mm, Hh, Ss, Ss, Ss, Re, Re, Gg, Gg^Ve, Ww, Ww, Ww, Ww, Ss, Ss, Ss, Re, Re, Hh, Hh, Mm, Mm, Mm, Mm, Mm
Ss, Gg, Re, Re, Ww, Ss, Gs^Fp, Gs^Fp, Ss, Ss, Ss, Ss, Ss, Hh, Mm, Mm, Mm, Mm, Mm, Ss, Ss, Ss, Re, Gg, Gg, Ww, Ww, Wo, Ww, Ww, Ss, Ss, Ss, Ss^Vhs, Ch, Hh, Hh, Mm, Mm, Hh, Hh, Mm
Gg, Re, Gg, Gg, Ww, Gs^Fp, Gs^Fp, Gs^Fp, Gs^Fp, Ss, Ss, Ss, Hh, Mm, Mm, Mm, Mm, Mm, Hh, Ss, Ss, Ss, Re, Gg^Ve, Ww, Ww, Ww, Ww, Ww, Ww, Ss, Ss, Ss, Ss, Ss, Ch, Hh, Hh, Hh, Ss, Ch, Ss
Ww^Bw/, Re, Gg, Ss, Ww, Gs^Fp, Gs^Fp, Ww, Gg^Ve, Gs^Fp, Ss, Ss, Hh, Hh, Mm, Mm, Mm, Hh, Ss^Vhs, Ss, Ss, Ch, Ss, Ww, Ww, Ww, Ww, Ww, Gs^Fp, Gs^Fp, Gs^Fp, Gs^Fp, Ss, Ss, Ss, Ww^Bw|, Ww^Bw\, Ss, Ww^Bw/, Ww^Bw/, Ss, Ss
Ss, Ss, Ss, Ss^Vhs, Ww, Gs^Fp, Gs^Fp, Ww, Gs^Fp, Gs^Fp, Ss, Hh, Mm, Mm, Mm, Mm, Hh, Ss, Ss, Ss, Ss, Ww^Bw|, Ww, Ww, Ww, Ww, Ww, Gg^Ve, Gs^Fp, Gs^Fp, Gs^Fp, Ss, Ss, Ss, Ch, Ch, Ch, Ch, Ss, Ss, Ss, Ww
Re, Hh, Hh, Hh, Ww, Gs^Fp, Gs^Fp, Gs^Fp, Gs^Fp, Ss, Ss, Hh, Mm, Mm, Mm, Mm, Gs^Fp, Ss, Ss, Ss, Ss, Ww^Bw|, Ww, Ww, Ww, Ww, Ss, Gs^Fp, Gs^Fp, Ss, Ss, Ss, Ss, Ss, Ch, 2 Kh, Ch, Ss, Ww, Ww, Ww, Ww
Mm, Mm, Mm, Hh, Ww, Gs^Fp, Ww, Gs^Fp, Ss, Ss, Gg, Hh, Mm, Mm, Mm, Mm, Ss, Ss, Ss, Ss, Ss, Ww^Bw|, Ww, Ww, Ww, Ss, Ss, Ss, Ss, Ss, Ss, Ss, Gg, Ch, Ch, Ch, Gg, Ww, Ww, Ww, Ss, Gg
Mm, Mm, Mm, Mm, Hh, Ww, Gs^Fp, Ww, Ww, Ww, Gg, Hh, Mm, Mm, Mm, Hh, Ww, Ss, Ss, Ss, Ss, Ww^Bw|, Ww, Ww, Ww, Gg, Gg, Gg, Ss, Ss, Hh, Hh, Hh, Gg, Gg, Gg, Ww, Ww, Ww, Ww, Ww, Ss
Mm, Mm, Mm, Mm, Hh, Ss, Ss, Ss, Ss, Ww, Ww, Hh, Mm, Mm, Ww, Ww, Ww, Ss, Ss, Ss, Ss, Re, Gg, Gg^Ve, Ww, Gg, Gg, Ss, Hh, Mm, Mm, Mm, Hh, Ss, Ss, Ww, Gg, Gg^Ve, Ww, Ww, Ww, Ww
Mm, Mm, Mm, Mm, Hh, Ss, Ss, Gg, Gg, Ww, Ww, Ww, Ww, Ww, Ss, Ww, Ss^Vhs, Ww, Ss, Gg, Gg, Re, Ww, Ww, Ss, Ww, Ww, Ss, Hh, Mm, Mm, Mm, Hh, Ss, Ww, Ww, Gg, Gg, Gg, Ww, Ww, Ww
Mm, Mm, Mm, Hh, Ss, Ss, Gg, Gg, Gg, Gg, Gg, Ww, Gg, Ss, Gg, Ss, Ss, Ww, Ww, Gg, Ss, Ss, Ww, Ss, Ss, Ww, Ww, Ww, Ww, Mm, Mm, Ww, Ww, Ss, Ww, Ss, Gg, Gg, Gg, Gg, Gg, Gg
