Ss, Hh, Hh, Hh, Hh, Hh, Gg, Gg, Ss, Ss, Ss, Gs^Fp, Re, Re, Re, Ch, Ww^Bw\, Ss, Ww^Bw/, Ww^Bw/, Ss, Ss, Re, Ss, Ss, Gg, Ww^Bw/, Ss, Ss, Hh, Hh, Hh, Ss, Ss, Ss, Hh, Hh, Hh, Mm, Mm, Mm, Hh
Ss, Ss^Vhs, Ss, Ss, Ss, Ss, Ss, Ss, Ss, Ss, Ww^Bw/, Re, Gs^Fp, Gs^Fp, Ss, Ss, Ss, Ch, Ss, Hh, Hh, Ss, Ss, Ww^Bw\, Re, Re, Gg, Ss, Ss, Hh, Hh, Ss, Ss, Ss, Ss, Ss, Ss^Vhs, Hh, Hh, Hh, Hh, Gg
Ss, Ss, Ss, Ss, Gs^Fp, Gs^Fp, Gs^Fp, Gs^Fp, Gs^Fp, Ch, Ss, Ss, Ss, Ss, Ss, Ss, Ss, Ss, Ss, Hh, Hh, Ss, Ss, Ss, Gg, Gg, Gg, Ss, Ss, Ss, Ss, Ss, Ss, Gs^Fp, Gs^Fp, Gs^Fp, Ss, Ss, Hh, Hh, Hh, Gg
Gs^Fp, Gs^Fp, Gs^Fp, Ch, Ch, Ch, Gs^Fp, Gs^Fp, Re, Re, Ss, Ss, Ss, Gs^Fp, Ss, Ss, Ss, Ss, Hh, Hh, Hh, Ss, Hh, Ss, Gg, Gg, Ss, Ss, Gs^Fp, Gs^Fp, Gs^Fp, Gs^Fp, Gs^Fp, Gs^Fp, Gg^Ve, Gs^Fp, Gs^Fp, Ss, Ss, Hh, Hh, Gg
Gs^Fp, Gs^Fp, Re, Ch, 1 Kh, Ch, Re, Re, Gs^Fp, Gs^Fp, Ss, Ss, Ss, Gs^Fp, Ss, Ss, Ss, Ss, Hh, Hh, Hh, Hh, Hh, Gg, Gg, Gg, Ss, Ss, Gs^Fp, Gs^Fp, Gs^Fp, Gs^Fp, Gs^Fp, Gs^Fp, Gs^Fp, Gs^Fp, Gs^Fp, Ss, Ss, Hh, Hh, Gg
Re, Re, Ch, Ch, Ch, Re, Gg^Ve, Re, Re, Ss, Ss, Ss, Ss, Ss^Vhs, Gs^Fp, Ss, Ss, Hh, Hh, Hh, Hh, Hh, Hh, Gg, Gg, Ss^Vhs, Ss, Ss, Gs^Fp, Ss, Ss, Ss, Ss, Ss, Ss, Ss, Ss, Ss, Ss, Hh, Hh, Gg
Re, Gs^Fp, Gs^Fp, Gs^Fp, Gs^Fp, Gs^Fp, Gs^Fp, Ww, Re, Ww, Ss, Ss, Ss, Ss, Ss, Ss, Ss, Hh, Hh, Hh, Hh, Hh, Hh, Ss, Ss, Ss, Ss, Ss, Ss, Ss, Ss, Ss, Ss, Ss, Ss, Ss, Ss, Ss, Ss, Ss, Ss, Ss
Re, Gs^Fp, Ss, Ss, Ss, Ss, Ss^Vhs, Ww, Ss, Ch, Gg, Gg, Ss, Ss, Ss, Ss, Ss, Ss, Hh, Hh, Hh, Ss, Ss, Ss, Ss, Ss, Ss, Ss, Ss, Ss, Ss^Vhs, Ss, Ss, Gg, Ss, Ss, Ss, Ss^Vhs, Ss, Hh, Hh, Ss
Ww^Bw|, Ss, Ss, Gs^Fp, Ss, Ss, Gg, Ss, Ss, Ww^Bw|, Ss, Ss, Gg, Ss, Ss, Ss, Ss, Ss, Ss, Hh, Ss, Ss, Ss, Ss, Ss, Ss, Ss, Ss, Ss, Ss, Ss, Gg, Ss, Ss, Ss, Ss, Ss, Ss, Hh, Hh, Hh, Ss
Ww^Bw|, Hh, Hh, Ss, Ss, Ss, Gg, Ss, Ss, Re, Ss, Ss, Ss, Ss, Ss, Ss, Ss, Ss, Ss, Ss^Vhs, Ss, Ss, Ss, Ss, Ss, Ss, Ss, Ss, Ss, Ss, Ss, Gg, Ss, Ss, Ss, Ss, Hh, Hh, Hh, Hh, Hh, Ss
Re, Hh, Mm, Mm, Hh, Ss, Ss, Ss, Ss, Re, Gs^Fp, Gs^Fp, Ss, Ss, Ss, Ss, Ss, Ss, Ss, Ss, Ss, Ss, Ss, Ss, Gg, Gg, Ss, Ss, Ss, Ss, Ss, Gg, Ss, Ss, Hh, Mm, Mm, Mm, Mm, Mm, Hh, Ss
Mm, Mm, Mm, Mm, Mm, Hh, Ss, Ss, Ss, Ww^Bw|, Gs^Fp, Gs^Fp, Ss, Ss, Ss^Vhs, Ss, Ss, Ss, Ss, Ss, Ss, Ss, Ss, Ss, Gg, Gg, Ss, Ss, Ss, Ss, Ss, Gg, Gg, Hh, Mm, Mm, Mm, Mm, Mm, Mm, Hh, Ss
Mm, Mm, Mm, Mm, Mm, Mm, Hh, Ss, Ss, Ch, Ch, Gs^Fp, Ss, Ss, Ss, Ss, Ss, Ss, Ss, Ss, Gs^Fp, Ss, Ss, Ss, Ss, Gg, Gg, Gg, Gg, Gg, Gg, Gg, Gg, Mm, Mm, Mm, Mm, Mm, Mm, Mm, Ss, Ss
Hh, Mm, Mm, Mm, Mm, Mm, Hh, Ss, Ss, Ss, Re, Ss, Ss, Ss, Ss, Ss, Ss, Ss, Ss, Ss, Gs^Fp, Ss, Gs^Fp, Gs^Fp, Ss, Gg, Gg, Gg, Gg, Gg, Ss, Ss, Hh, Mm, Mm, Mm, Mm, Mm, Mm, Hh, Ss, Gs^Fp
Ss, Hh, Mm, Mm, Mm, Hh, Ss^Vhs, Ss, Ss, Ss^Vhs, Ss, Ch, Ss, Ss, Ss, Ss, Ss, Ss, Ss, Gs^Fp, Gs^Fp, Ss, Gs^Fp, Gs^Fp, Ss, Ss^Vhs, Gg, Gg, Ss, Ss, Ss, Ss, Hh, Mm, Mm, Mm, Mm, Mm, Mm, Ss, Ss, Ss
Ss, Ss, Hh, Hh, Hh, Hh, Ss, Ss, Ss, Ss, Ss, Ww^Bw|, Gg, Ss, Ss, Ss, Ss, Ss, Gs^Fp, Gg^Ve, Gs^Fp, Gs^Fp, Ss, Ss, Ss, Ss, Gg, Ss, Ss, Ss, Ss, Hh, Mm, Mm, Mm, Mm, Mm, Mm, Hh, Ss, Gs^Fp, Gs^Fp
Ss, Ss, Ss, Ss, Ss, Ss, Ss, Ss, Ss, Ss, Gg, Re, Gg, Ss, Ss, Ss, Gs^Fp, Gs^Fp, Ss, Gs^Fp, Gs^Fp, Ss, Ss, Ss, Ss, Ss, Ss, Ss, Ss, Hh, Mm, Mm, Mm, Hh, Mm, Mm, Mm, Hh, Hh, Ss, Gs^Fp, Gs^Fp
Gs^Fp, Ss, Ss, Ss, Ss, Ss, Ss, Ss, Ss, Gg, Gg, Re, Gg, Ss, Ss, Ss, Ss, Ss, Ss, Ss, Ss, Ss, Ss, Ss, Ss, Ss, Ss, Ss, Ss, Hh, Mm, Mm, Hh, Hh, Hh, Hh, Hh, Ss, Gg, Gg, Ss, Ss
Gs^Fp, Gs^Fp, Ss, Ss, Ss, Ss, Ss, Gg, Gg, Gg, Gg, Re, Re, Ss, Ss, Ss, Gs^Fp, Ss, Ss, Gs^Fp, Ss, Ss, Ss, Ss, Ss, Ss, Ss, Ss, Ss, Hh, Hh, Hh, Hh, Hh, Hh, Ss^Vhs, Ss, Ss, Gg, Gg, Gg, Ss
Gs^Fp, Ss, Ss, Ss, Gg, Gg, Ss, Ss, Ss, Ss, Ss, Gg, Re, Gg, Ss, Ss, Ss, Ss, Ss, Ss, Ss, Ss, Ss, Ss, Gg, Ss^Vhs, Ss, Ss, Ss, Ss, Ss, Ss, Ss, Ss, Ss, Ss, Ss, Ss, Gg, Ss, Gg, Ss
Ss, Ss, Ss, Gg, Gg, Ss, Ss, Ss, Ss, Gs^Fp, Ss, Gg, Re, Gg^Ve, Re, Ss, Ss, Ss, Ss, Ss, Ss, Ss, Ss, Ss, Ss, Ss, Ss, Ss, Ss, Ss, Ss, Gg, Gg, Gg, Gg, Gg, Gg, Gg, Ss, Gg, Gg, Gg
Ss, Ss, Ss, Ss, Gg, Gg, Ss, Ss, Gs^Fp, Gs^Fp, Ss, Ss, Gg, Re, Ss, Re, Re, Hh, Ss^Vhs, Ss, Ss, Ss, Ss, Ss, Ss, Ss, Ss, Ss, Ss, Ss, Gg, Gg, Gg, Ss, Gg, Gg, Gg, Ss, Ss, Ss, Gg, Ss
Ss, Ss, Ss, Ss, Gg, Gg, Ss, Ss, Gs^Fp, Gg^Ve, Ss, Ss, Gg, Gg, Gg, Hh, Hh, Re, Re, Ss, Ss, Ss, Ss, Ss, Ss, Ss, Ss, Ss, Ss, Ss, Gg, Gg, Ss, Gg, Gg, Ss, Ss, Ss, Ss, Ss, Ss, Ss
Ss, Ss, Ss, Ss, Gg, Gg, Ss, Ss, Ss, Gs^Fp, Gs^Fp, Ss, Ss, Gg, Gg, Hh, Mm, Mm, Hh, Re, Ss, Ss, Ss, Gs^Fp, Gs^Fp, Ss, Ss, Ss, Ss, Ss, Ss, Ss, Ss, Ss, Ss, Ss, Gs^Fp, Gs^Fp, Gs^Fp, Ss, Ss, Ss
Ss, Ss, Gs^Fp, Ss, Gg, Gg, Ss, Ss, Ss, Ss, Ss, Ss, Ss, Ss, Ss, Hh, Mm, Mm, Mm, Ch, Re, Ss, Ss, Ss, Ww, Ww, Ss, Ss, Ss, Ss, Ss, Ss, Ss, Ss, Ss, Ss, Gs^Fp, Gg^Ve, Gs^Fp, Gs^Fp, Gs^Fp, Gs^Fp
Ss, Ss, Ss, Ss, Gg, Gg, Gg, Ss, Ss, Ss, Ss, Ss, Ss, Ss, Ss, Hh, Mm, Mm, Hh, Ss, Re, Gg, Ss, Ss, Ww, Ww, Ss, Ss, Ss, Ss, Ss, Ww, Ww, Ww, Ss^Vhs, Ss, Ss, Ww, Ww, Gs^Fp, Gs^Fp, Gs^Fp
Ss, Ss, Ss^Vhs, Ss, Gg, Gg, Gg, Ss, Ss, Ss, Gg, Ss, Ss, Ss^Vhs, Ss, Hh, Hh, Hh, Hh, Ss, Gg, Re, Gg, Gg, Ww, Ww, Ww, Gg, Ss, Ss, Ss, Ww, Ww, Ww, Ww, Ww, Ww, Ww, Ww, Gs^Fp, Gs^Fp, Gs^Fp
Ss, Ss, Ss, Ss, Gg, Ss, Gg, Gg, Gg, Ss, Ss, Ss, Ss, Ss, Ss, Hh, Hh, Hh, Ss, Ss, Gg, Re, Re, Gg, Ww, Ww, Ww, Ww, Ss, Ss, Gs^Fp, Gs^Fp, Ww, Ww, Ww, Ww, Ww, Ww, Ww, Gs^Fp, Gs^Fp, Gs^Fp
Ss, Ss, Ss, Ss, Gg, Gg, Gg^Ve, Gg, Gg, Ss, Ss, Ss, Gg, Gg, Gg, Gg, Hh, Hh, Ss, Ss, Ss, Ss, Ss, Re, Ww, Ww, Ww, Ss^Vhs, Ww, Gs^Fp, Gs^Fp, Gs^Fp, Ww, Ww, Wo, Wo, Ww, Ww, Ss, Ss, Gs^Fp, Ss
Ss, Ss, Gg, Gg, Gg, Gg, Gg, Gg, Ss, Ss, Ss, Ss, Gg, Gg, Gg, Gg, Gg, Ss, Ss, Gs^Fp, Gs^Fp, Ss, Ss, Re, Re, Ww, Ww, Ww, Gs^Fp, Gs^Fp, Ss, Ss, Ww, Ww, Ww, Ww, Ww, Ss^Vhs, Ss, Ss, Ss, Ss
Gg, Gg, Gg, Ss, Gg, Gg, Gg, Ss, Ss, Ss, Ss, Gg, Gg, Gg, Gg, Gg, Gg, Ss, Ss, Gs^Fp, Gg^Ve, Gs^Fp, Ss, Gg, Gg, Ww^Bw\, Ww^Bw\, Ss, Ss, Ss, Ss, Ss, Ss, Ss^Vhs, Ss, Ww, Ss, Ss, Ss, Ss, Ss, Ss
Ss, Ss, Ss, Ss, Ss, Ss, Ss, Ss, Ss, Ss, Ss, Gg, Gg, Gg, Gg, Gg, Gg, Ss, Ss, Gs^Fp, Gs^Fp, Gs^Fp, Ss, Ss, Ss, Ss, Ss, Ww^Bw\, Ww^Bw\, Ss, Ss, Ss, Ss, Ss, Ss, Ss, Ss, Ss, Gs^Fp, Ss, Ss, Hh
Ss, Ss, Ss, Gs^Fp, Gs^Fp, Gs^Fp, Gs^Fp, Gs^Fp, Ss, Gg, Gg, Ss, Gg, Gg, Gg, Gg, Gg, Ss, Ss, Ss, Ss, Ss, Ss, Ss, Ss, Gs^Fp, Ss, Ss, Ww^Bw|, Ww^Bw\, Re, Gg, Re, Ss, Ss, Ss, Ss, Gs^Fp, Gs^Fp, Ss, Ss, Ss
Ss, Ss, Ss, Ss, Gs^Fp, Gs^Fp, Gs^Fp, Ss, Ss, Gg, Gg, Gg, Gg, Gg, Ss, Gg, Gg^Ve, Gg, Gg, Ss, Ss, Ss, Ss, Ss, Ss, Ss, Gs^Fp, Gs^Fp, Re, Ss, Gg, Re, Ss, Ch, Ss, Ss, Ss, Ss, Ss, Ss, Hh, Hh
Ss, Ss, Gg, Ss, Gs^Fp, Gs^Fp, Gs^Fp, Ss, Ss^Vhs, Gg, Gg, Gg, Gg, Ss, Ww, Ww, Ww, Ss, Gg, Gg, Ss, Ss, Ss, Hh, Ss, Ss, Ss, Gs^Fp, Re, Ss, Ss, Ss, Ss, Ch, Re, Gg, Ss, Ss, Ss, Hh, Hh, Hh
Ss, Ss, Ss, Ss, Gs^Fp, Ss, Ss, Ss, Ss, Gg, Gg, Gg, Gg, Ss, Ww, Ww, Ww, Ww, Gg, Gg, Gg, Ss, Hh, Hh, Hh, Hh, Ss, Ss^Vhs, Ww^Bw|, Ss, Gs^Fp, Ss, Ss, Ss, Re, Ch, Ch, Ch, Hh, Hh, Hh, Hh
Ss, Gs^Fp, Gg^Ve, Gs^Fp, Ss, Ss, Ss, Ss, Gg, Gg, Gg, Gg, Ss, Ss, Ww, Ww, Ww, Ww, Gg, Gg, Gg, Ss^Vhs, Hh, Mm, Mm, Hh, Ss, Ss, Ww^Bw|, Ss, Ss, Ss, Ss, Ss^Vhs, Gg, Ch, 2 Kh, Ch, Mm, Mm, Hh, Hh
Ss, Gs^Fp, Gs^Fp, Gs^Fp, Ss, Ss, Gg, Gg, Gg, Gg, Ss, Gg, Gg, Ss, Ww, Ww, Ss, Ss, Ss, Gg, Gg, Hh, Mm, Mm, Mm, Mm, Ss, Ss, Re, Ss, Ss, Ss, Ss, Ss, Ch, Ch, Ch, Hh, Hh, Mm, Mm, Hh
Ss, Gs^Fp, Gs^Fp, Gs^Fp, Ss, Ss, Gg, Ww, Gg^Ve, Ss, Gg, Gg, Gg, Ss, Ss, Ss^Vhs, Ss, Ss, Ss, Gg, Hh, Mm, Mm, Mm, Mm, Mm, Ch, Ww^Bw/, Ss, Ss, Ss, Ss, Ss, Ss, Ss, Ss, Ss, Hh, Hh, Mm, Mm, Mm
Ss, Ss, Gs^Fp, Gs^Fp, Ss, Ss, Ss, Ww, Ss, Gg, Gg, Gg, Gg, Ss, Ss, Ss, Ss, Ss, Ss, Hh, Mm, Mm, Mm, Mm, Mm, Hh, Ww^Bw|, Ss, Ss, Ss, Ss, Ss, Ss, Ss, Ss, Ss, Ss, Ss, Ss, Hh, Hh, Hh
Ss, Ss, Gs^Fp, Ss, Ss, Ss, Ss, Ss, Ss, Ss, Gg, Gg, Ss, Ss, Ss, Ss, Ss, Ss, Hh, Mm, Mm, Mm, Mm, Mm, Mm, Hh, Ch, Hh, Ss, Ss, Ss, Ss, Gs^Fp, Ss, Ss, Ss, Ss, Ss, Ss, Ss, Ss, Ss
Ss, Ss, Ss, Ss, Ss, Ss, Gs^Fp, Gs^Fp, Gs^Fp, Ss, Gg, Gg, Ss, Ss, Gs^Fp, Ss, Ss, Ss, Hh, Mm, Mm, Mm, Mm, Mm, Mm, Re, Hh, Ss, Ss, Ss, Ss, Ss, Ss, Ss, Ss, Ss, Gg, Gg, Gg, Ss, Ss, Ss
