Ss, Ss, Ss, Ss, Ss, Ss, Ss, Hh, Hh, Mm, Mm, Mm, Mm, Mm, Hh, Hh, Hh, Ss, Ss, Ss, Ss, Ss, Ss, Gg, Ss, Hh, Ss, Ss, Ss, Gs^Fp, Gs^Fp, Ss, Ss, Hh, Hh, Hh, Ss, Gg, Gg, Re, Ss, Gg
Ss, Ss, Ss, Ss, Gs^Fp, Ss, Ss, Ss, Ss, Ss^Vhs, Hh, Hh, Hh, Hh, Hh, Hh, Hh, Ss, Ss, Ss, Ss, Ss, Ss, Gg, Hh, Hh, Ss, Ss, Ss, Ss, Ss, Ss, Hh, Hh, Mm, Mm, Hh, Gg, Gg, Re, Gg, Ww
Ss, Ss, Ss, Ss, Ss, Ss, Ss, Ss, Ss, Ss, Gg, Gg, Ss^Vhs, Ss, Ss, Ss, Ss, Ss, Hh, Ss, Hh, Hh, Gg, Gg, Hh, Hh, Hh, Ss, Ss, Ss, Ss, Hh, Hh^Vhh, Mm, Mm, Mm, Mm, Hh, Gg, Re, Ss^Vhs, Ww
Ss, Ss, Hh, Ch, Ch, Ch, Ss, Ss, Ss, Ss, Ss, Gg, Ss, Ss, Ss, Ss, Ss, Ss, Ss, Hh, Gg, Hh, Hh, Gg, Hh, Hh, Hh, Hh, Ss, Hh, Mm, Mm, Mm, Mm, Mm, Mm, Mm, Hh, Gg, Re, Ss, Gs^Fp
Ss, Ss, Ss, Ch, 1 Kh, Ch, Ss, Ss, Ss, Ss, Ss, Ss, Ss, Gg, Ss, Ss, Ss, Ss, Ss, Ss, Hh, Hh, Hh, Hh, Hh, Hh, Hh, Hh, Hh, Hh, Mm, Mm, Mm, Mm, Mm, Mm, Hh, Hh, Ss, Re, Ss, Gs^Fp
Ss, Ss, Ch, Ch, Ch, Ss, Ss, Gs^Fp, Ss, Ss, Gs^Fp, Ss, Ss, Gg, Ss, Ss, Ss, Ss, Ss, Ss, Ss, Ss, Hh, Ss, Hh, Ss^Vhs, Hh, Hh, Hh, Mm, Mm, Mm, Mm, Mm, Mm, Mm, Ss, Ss, Ss, Re, Ss, Ss
Ss, Ss, Ss, Ss, Ss^Vhs, Re, Gs^Fp, Gs^Fp, Gs^Fp, Ww, Ww, Ww, Ss, Gg, Ss, Ss, Ss, Ss, Ss, Ss, Ss, Ss, Ss, Ss, Ss, Ss, Hh, Hh, Hh, Hh, Mm, Mm, Mm, Mm, Mm, Hh, Ss, Ss, Ss, Re, Ss, Gs^Fp
Ss, Gs^Fp, Gs^Fp, Ss, Gs^Fp, Re, Gs^Fp, Gg^Ve, Gs^Fp, Ww, Ww, Ss, Ss, Ss, Ss, Ss, Gs^Fp, Gs^Fp, Gs^Fp, Gs^Fp, Gs^Fp, Ss, Ss, Ss, Ss, Ss, Ss, Ss, Ss, Ss, Mm, Mm, Mm, Mm, Mm, Hh, Ss, Ss, Ss, Re, Ss, Gs^Fp
Ss, Ss, Ss, Ss, Ss, Ww^Bw|, Ss, Ss, Ss, Ss, Ss, Ss, Ss, Ss, Ss, Ss, Ss, Gs^Fp, Gs^Fp, Gg^Ve, Gs^Fp, Gs^Fp, Gs^Fp, Gs^Fp, Ss, Ss, Ss, Ss, Ss, Ss, Hh, Mm, Mm, Mm, Mm, Hh, Ss, Ss^Vhs, Re, Ch, Ss, Ss
Ss, Gg, Ss, Ss, Ss, Ch, Ch, Ss, Ss, Ss, Ss, Ss, Ss, Ss, Gs^Fp, Ss, Ss, Ss, Ss, Gs^Fp, Ss, Ss, Ss, Ss, Gs^Fp, Gs^Fp, Gs^Fp, Gs^Fp, Gs^Fp, Ss, Hh, Mm, Mm, Mm, Mm, Mm, Ss, Ss, Ww^Bw|, Ss, Ss, Ss
Ss, Gg, Gg, Ss, Ss, Ss, Re, Gs^Fp, Ss, Ss, Ss, Ss, Gs^Fp, Gs^Fp, Ss, Ss, Ss, Ss, Ss, Ss, Ss, Ss, Ss, Ss, Ss, Ss, Gs^Fp, Gs^Fp, Gs^Fp, Ss, Ss, Mm, Mm, Mm, Mm, Mm, Hh, Ss, Ww^Bw|, Ss, Ss, Ss
Ss, Ss, Ss, Ss, Ss, Gs^Fp, Gg^Ve, Re, Re, Ss, Ss, Gs^Fp, Gg^Ve, Gs^Fp, Ss, Ss, Ss, Ss, Ss, Ss, Ss, Ss, Ss, Ss, Ss, Gs^Fp, Gg^Ve, Gs^Fp, Gs^Fp, Ss, Ss, Mm, Mm, Mm, Mm, Mm, Hh, Ss, Ch, Ss, Ss, Ss
Ss, Ss, Ss, Gg, Ss, Ss, Gs^Fp, Gs^Fp, Gs^Fp, Re, Re, Gs^Fp, Gs^Fp, Gs^Fp, Ss, Ss, Ss, Ss, Ss, Ss, Ss, Ss, Ss, Ss, Ss, Gs^Fp, Gs^Fp, Gs^Fp, Gs^Fp, Gs^Fp, Ss, Hh, Mm, Mm, Hh, Hh, Ss^Vhs, Ch, Ss, Ss, Ss, Ww
Ss, Ss, Ss, Gg, Gg, Ss, Gs^Fp, Gg^Ve, Gs^Fp, Gs^Fp, Gs^Fp, Re, Gs^Fp, Gs^Fp, Ss, Ss, Ss, Gg, Gg, Ss, Ss, Ss, Ss, Ss, Ss, Ss, Gs^Fp, Gs^Fp, Gs^Fp, Gs^Fp, Ss, Ss, Hh, Hh, Hh, Hh, Hh, Ww^Bw|, Ss, Ss, Ss, Ww
Ss, Ss, Ss, Gg, Gg, Ss, Gs^Fp, Gs^Fp, Gs^Fp, Gs^Fp, Gs^Fp, Re, Re, Gs^Fp, Ss, Ss, Ss, Gg, Gg, Gg, Ss, Ss, Ss, Ss, Ss, Ss, Ss, Ss, Ss, Ss, Ss, Ss, Hh, Hh, Hh, Hh, Hh, Ch, Re, Ss, Ss, Ss
Ss, Ss, Ss, Gg, Gg, Ss, Gs^Fp, Gs^Fp, Gs^Fp, Gs^Fp, Gs^Fp, Gs^Fp, Gs^Fp, Re, Re, Gs^Fp, Gs^Fp, Ss, Gg, Gg, Ss, Ss, Ss, Ss, Ss, Ss, Ss, Gs^Fp, Gs^Fp, Gs^Fp, Ss, Ss, Ss, Ss, Hh, Hh, Ss, Ss, Gg, Re, Ss^Vhs, Ss
Ss, Ss, Ss, Gg, Gg, Ss, Ss, Ss, Gs^Fp, Gs^Fp, Gs^Fp, Gs^Fp, Gs^Fp, Gs^Fp, Gs^Fp, Re, Re, Ss, Gg, Gg, Gg, Gg, Gg, Gg, Ss, Ss, Ss, Gs^Fp, Gg^Ve, Gs^Fp, Ss^Vhs, Ss, Ss, Ss, Ss, Ss, Ss, Ss, Gg, Re, Ww^Bw\, Gg
Gs^Fp, Ss, Ss, Ss, Ss, Ss, Ss, Ss, Ss, Gs^Fp, Gs^Fp, Gs^Fp, Gg^Ve, Gs^Fp, Gs^Fp, Gs^Fp, Gs^Fp, Ww^Bw\, Re, Gg, Gg, Gg, Gg, Gg, Gg, Ss, Ss, Ss, Ss, Gs^Fp, Ss, Ss, Ss, Ss, Ss, Ss, Ss, Gg, Gg, Ss, Gg, Re
Gs^Fp, Ss, Ss, Ss, Ss, Ss, Ss^Vhs, Ss, Ss, Ss, Gs^Fp, Gs^Fp, Gs^Fp, Gs^Fp, Gs^Fp, Gs^Fp, Gs^Fp, Ss, Gg, Re, Re, Gg, Gg, Gg, Gg, Ss, Ss, Gs^Fp, Ss, Gs^Fp, Ss, Ss, Ss, Ss, Ss, Ss, Ss, Ss, Ss, Ss, Ss, Re
Gs^Fp, Ss, Ss^Vhs, Ss, Hh, Ss, Ss, Gg, Gg, Gg, Ss, Gs^Fp, Gs^Fp, Gs^Fp, Gs^Fp, Gs^Fp, Gs^Fp, Ss, Ss, Ss, Ss^Vhs, Re, Gg, Gg, Gg, Gg, Ss, Ss, Ss, Ss, Ss, Ss, Gg, Ss, Ss, Ss, Ss, Ss, Ss, Ss, Ss, Ss
Ss, Ss, Ss, Ss, Ss, Ss, Ss, Gg, Gg, Gg, Ss, Gs^Fp, Gs^Fp, Gs^Fp, Gs^Fp, Gs^Fp, Gs^Fp, Ss, Ss, Ss, Gg, Re, Gg, Gg, Gg, Gg, Gg, Ss, Ss, Ss, Gg, Ss, Gg, Ss, Ss, Ss, Ss, Gg, Ss, Ss, Ss, Ss
Ss, Ss, Ss, Ss, Ss, Ss, Ss, Gg, Gg, Gg, Ss, Ss, Ss, Ss, Gs^Fp, Ss, Ss, Ss, Ss, Gg, Gg, Re, Re, Re, Re, Ss, Ss, Ss, Ss, Ss, Ss, Gg, Ss, Ss, Ss, Ss, Ss, Ss, Ss, Ss, Ss, Ss
Ss, Ss, Ss, Ss, Ss, Ss, Ss, Gg, Gg, Gg, Gg, Gg, Gg, Ss, Ss, Ss, Ss, Ss, Ss, Ss, Gg, Gg, Ww, Ww, Ww, Ch, Ss, Ss, Ss, Ss, Ss, Ss, Ss, Ss, Ss, Ss, Ss, Ss, Ss, Ss, Gg, Gg
Ss, Ss, Ss, Ss, Ss, Ss, Ss, Gg, Gg, Gg, Gg, Gg, Gg^Ve, Gg, Ss, Ss, Ss, Ss, Ss, Ss, Ss, Gg^Ve, Ww, Ww, Ww, Re, Gs^Fp, Gs^Fp, Ss, Ss, Ss, Ss, Ss, Ss, Ss, Ss, Gs^Fp, Ss, Ss, Gg, Gg, Gg
Gg, Gg, Gg, Gg, Gg, Gg, Ss, Ss, Gg, Gg, Gg, Gg, Gg, Gg, Ss, Ss, Ss, Ss, Ss, Ss, Ss, Ss, Ss, Ww, Ww, Re, Re, Ss, Ss, Ss, Ss, Ss, Ss, Ss, Ss, Gs^Fp, Ss, Gs^Fp, Ss, Ss, Ss, Ss
Hh, Ss, Gg, Gg, Gg, Gg, Gg, Ss, Gg, Gg, Gg, Gg, Gg, Gg, Gg, Ss, Ss, Ss, Ss, Ss, Ss, Ss, Ss, Gs^Fp, Gs^Fp, Gg^Ve, Re, Ss, Ss, Ss, Ss, Ss, Ss, Ss, Ss, Gs^Fp, Gg^Ve, Gs^Fp, Ss, Ss, Ss^Vhs, Ww
Hh, Hh, Ss^Vhs, Gg, Gg, Gg, Gg, Ss, Ss^Vhs, Gg, Gg, Gg, Gg, Gg, Gg, Ss, Ss, Ss, Ss, Ss, Ss, Ss, Ss, Ss, Ss, Gs^Fp, Gs^Fp, Ch, Ss, Ss, Ss, Gg, Ss, Ss, Gs^Fp, Gs^Fp, Gs^Fp, Gs^Fp, Gs^Fp, Ss, Ss, Ww
Hh, Hh, Gg, Gg, Gg, Gg, Gg, Ss, Ss, Ss, Ss, Ss, Gg, Gg, Gg, Ss, Ss, Ss, Gs^Fp, Ss, Ss, Ss, Ss, Ss, Ss, Ss, Ss, Re, Ww^Bw\, Ss, Ss, Gg, Ss, Ss, Ss, Ss, Ss, Gs^Fp, Gs^Fp, Gs^Fp, Ss, Ss
Ss, Ss, Gg, Gg, Gg, Gg, Gg, Ss, Ss, Ss, Ss, Ss, Ss, Gg, Gg, Gg, Ss, Ss, Ww, Ww, Ss, Ss, Ss, Gg, Gg, Gg, Ss, Ss, Gs^Fp, Re, Ss, Ss, Gg, Ss, Ss, Ss, Ss, Ss, Ss, Gs^Fp, Ss, Ss
Gg, Gg, Gg, Gg, Ss, Ss, Ss, Ss, Ss, Ss, Ss, Ss, Ss, Gg, Gg, Ss, Ss, Gs^Fp, Ww, Ww, Ww, Ss, Gg, Gg, Gg, Gg, Ss, Gs^Fp, Gs^Fp, Re, Re, Ss, Ss, Ss, Ss, Ss, Ss, Ss, Ss, Ss, Ss, Ss
Gg, Gg, Gg, Ss, Ss, Ss, Ss, Ss, Ss, Ss, Ss, Ss, Ss, Ww, Ww, Ss, Ss, Ss, Ww, Ww, Ww, Ss, Ww, Ww, Ww, Ss, Gs^Fp, Gs^Fp, Gs^Fp, Gs^Fp, Re, Gs^Fp, Ss, Ss, Ss, Ss, Ss, Gs^Fp, Ss, Ss, Ss, Ss
Ss, Gg, Gg, Ss, Ss, Gs^Fp, Gs^Fp, Ss, Ss, Ss, Ss, Ss, Ss, Ww, Ss^Vhs, Ss, Ss, Ss, Gs^Fp, Ss, Ww, Ss^Vhs, Ww, Ss, Ww, Ss, Ss, Ss, Ss, Ss, Gs^Fp, Re, Ww, Ww, Ww, Ww, Ss^Vhs, Ss, Ss, Gg, Gg, Ss
Ss, Ss^Vhs, Gg, Gg, Ss, Ss, Gs^Fp, Gs^Fp, Ss, Ss, Ss, Ss, Ss, Gs^Fp, Ss, Ss, Ss, Gs^Fp, Ss, Ss, Ww, Ww, Ss, Ss, Ww, Ww, Ss^Vhs, Ss, Ww, Ss, Ss, Re, Ww^Bw\, Ss, Ss^Vhs, Ww, Ss, Ss, Ss, Gg, Gg, Gg
Ss, Ss, Gg, Ss, Ss, Ss, Ss, Gs^Fp, Gs^Fp, Gs^Fp, Ss, Ss, Gs^Fp, Gs^Fp, Gs^Fp, Ss, Ss, Gs^Fp, Ss, Ss, Hh, Ww, Ss, Ss, Ss, Ww, Ww, Ww, Ww, Ww, Ww, Ww, Ss, Ww^Bw\, Re, Ww, Gg, Gg, Gg, Gg, Gg, Gg
Ss, Gg, Gg, Ss, Ss, Ss, Ss, Gs^Fp, Gg^Ve, Gs^Fp, Ss, Gs^Fp, Gs^Fp, Gs^Fp, Gs^Fp, Ss, Ss, Ss, Ss, Hh, Hh, Hh, Hh, Ss, Ss, Ss, Ss, Ww, Ss, Ss, Ss, Ww, Ss, Ss, Gg, Re, Gg, Gg, Gg, Gg, Gg, Gg
Ss, Gg, Gg, Ss, Ss, Ss, Gs^Fp, Gs^Fp, Gs^Fp, Gs^Fp, Gs^Fp, Gs^Fp, Gs^Fp, Gs^Fp, Ss, Ss, Ss, Ss, Ss, Hh, Hh, Mm, Hh, Ss, Ss, Gs^Fp, Gs^Fp, Gs^Fp, Ss, Ss, Ss, Gg, Gg, Gg, Gg, Ch, Ch, Ch, Gg, Gg, Gg, Gg
Ss, Gg, Ss, Ss, Ss, Gs^Fp, Gs^Fp, Gs^Fp, Gs^Fp, Gs^Fp, Gs^Fp, Gs^Fp, Gs^Fp, Gs^Fp, Gs^Fp, Ss, Ss, Ss, Ss, Hh, Hh, Hh, Hh, Ss, Gs^Fp, Gs^Fp, Gs^Fp, Ss, Ss, Ss, Ss, Hh, Hh, Gg, Ss, Ch, 2 Kh, Ch, Ss, Ss, Ss, Ss
Gg, Gg, Ss, Ss, Gs^Fp, Gs^Fp, Gs^Fp, Ss, Gs^Fp, Gs^Fp, Gs^Fp, Gs^Fp, Gs^Fp, Gg^Ve, Gs^Fp, Ss, Ss, Ss, Ss, Hh, Hh, Hh, Ss, Ss, Gs^Fp, Gs^Fp, Gs^Fp, Ss, Ss, Hh, Hh, Hh, Hh, Ss^Vhs, Ch, Ch, Ch, Ss, Ss^Vhs, Ss, Ss, Ss
Gg, Ww, Ww, Ww, Gg^Ve, Gs^Fp, Gs^Fp, Ss, Ss, Gs^Fp, Gs^Fp, Gs^Fp, Gs^Fp, Gs^Fp, Ss, Ss, Ss, Ss, Ss, Ss^Vhs, Ss, Ss, Ss, Gs^Fp, Ss, Ss, Gs^Fp, Ss, Gg, Mm, Mm, Mm, Hh, Ss, Ss, Hh, Hh, Hh, Ss, Ss, Ss, Ss
Ss, Ww, Ww, Ww, Gs^Fp, Gs^Fp, Ss^Vhs, Ss, Ss, Ss, Gs^Fp, Gs^Fp, Ss, Ss, Ss, Ss, Ss, Ss, Hh, Hh, Hh, Ss, Ss, Gs^Fp, Gs^Fp, Gs^Fp, Ss, Ss, Hh, Mm, Mm, Mm, Mm, Hh, Hh, Hh, Mm, Hh, Hh, Ss, Ss, Ss
Ss, Ss, Ss, Ss, Ss, Ss, Ss, Ss, Ss, Ss, Ss, Gs^Fp, Gs^Fp, Ss, Ss, Ss, Ss, Ss, Hh, Ss, Ss, Ss, Ss, Ss, Ss, Ss, Ss^Vhs, Ss, Hh, Mm, Mm, Mm, Mm, Mm, Hh, Mm, Mm, Mm, Hh, Ss, Ss, Ss
Ss, Ss, Ss, Ss, Ss, Ss, Ss, Hh, Ss, Ss, Ss, Gs^Fp, Ss, Ss, Ss, Ss, Ss, Ss, Ss, Gg, Gg, Ss, Ss, Ss, Ss, Ww, Gg, Ww, Hh, Mm, Mm, Mm, Mm, Mm, Mm, Hh, Mm, Mm, Ss, Ss, Ss, Ss
