Ww, Ss, Gs^Fp, Ss, Ss, Ss, Ss, Ss, Gg, Ss, Ss, Hh, Gg, Gg, Gg, Ss, Ss, Hh, Hh, Hh, Hh, Hh, Hh, Ss, Ss, Gs^Fp, Gs^Fp, Ss, Ss, Ss, Hh, Mm, Mm, Mm, Mm, Mm, Mm, Mm, Mm, Hh, Re, Ss
Ww, Ww, Ww, Ss, Ww, Gg, Gg^Ve, Gg, Gg, Gg, Gg, Hh, Hh, Hh, Gg, Ss^Vhs, Hh, Mm, Hh, Mm, Mm, Mm, Hh, Ss, Ss, Gs^Fp, Gs^Fp, Gs^Fp, Ss, Hh, Mm, Mm, Mm, Mm, Mm, Mm, Hh, Hh, Hh, Hh, Hh, Ss
Wo, Wo, Wo, Ww, Ww, Ww, Ww, Gg^Ve, Gg, Gg, Gg, Hh, Hh, Hh, Hh, Hh, Hh, Mm, Mm, Mm, Mm, Mm, Hh, Ss, Ss, Ss, Ss, Ss, Ss, Mm, Mm, Mm, Mm, Mm, Mm, Mm, Hh, Hh, Hh, Hh, Ss, Ss
Wo, Ww, Ww, Wo, Wo, Ww, Ww, Gg, Gg, Gg, Gg, Hh, Hh, Hh, Hh, Hh, Hh, Mm, Mm, Mm, Mm, Mm, Mm, Hh, Ss, Ss, Ss, Ss, Hh, Mm, Mm, Mm, Mm, Mm, Mm, Ch, Ch, Ch, Hh, Hh, Gg, Ss
Wo, Wo, Wo, Wo, Ww, Ww, Gg, Gg, Gg, Gg, Gg, Gg, Hh, Ss, Hh, Hh, Hh, Mm, Mm, Mm, Mm, Mm, Mm, Mm, Hh, Hh, Ss, Ss, Ss, Hh, Hh, Mm, Mm, Mm, Re, Ch, 2 Kh, Ch, Hh, Hh, Gg, Gg
Wo, Wo, Wo, Ww, Ww, Ss, Ss, Gg, Gg, Ss, Ss, Ss, Ss, Hh, Hh, Hh, Hh, Hh, Mm, Mm, Mm, Mm, Mm, Mm, Hh, Hh, Ss, Ss, Ss, Ss, Ss, Hh, Ss, Hh, Ch, Ch, Ch, Hh, Hh, Hh, Gg, Ss
Ww, Ww, Ww, Ww, Ww, Gs^Fp, Ss, Ss, Ss^Vhs, Ss, Ss, Ss, Ss, Hh, Hh, Hh, Hh, Hh, Mm, Mm, Mm, Mm, Mm, Mm, Hh, Hh, Ss, Ss, Gs^Fp, Ss, Ss, Ss, Ch, Ww^Bw/, Ss, Ss, Ss, Hh, Hh, Hh, Hh, Ss
Ww, Ww, Ww, Ww, Gg^Ve, Gs^Fp, Ss, Ss, Ss, Ss, Ss, Ss, Ss, Hh, Hh, Hh^Vhh, Hh, Mm, Mm, Mm, Mm, Mm, Mm, Mm, Hh^Vhh, Ww, Ss, Gs^Fp, Gs^Fp, Gs^Fp, Gs^Fp, Gs^Fp, Re, Ss, Ss, Ss, Hh, Hh, Hh, Hh, Ss, Ss
Ss, Ww, Ww, Ww, Gs^Fp, Gs^Fp, Gs^Fp, Ss, Ss, Ss, Ss, Ss, Hh, Mm, Mm, Mm, Mm, Hh, Hh, Mm, Mm, Mm, Mm, Mm, Hh, Ww, Ww, Gs^Fp, Ww, Gs^Fp, Re, Re, Gs^Fp, Ss^Vhs, Ss, Hh, Hh, Hh, Hh, Hh, Ss, Ss
Ss, Gs^Fp, Ww, Ww, Gs^Fp, Gs^Fp, Gs^Fp, Ss, Ss, Ss, Ss, Ss, Hh, Hh, Mm, Mm, Mm, Mm, Hh, Mm, Mm, Mm, Mm, Mm, Hh, Ww, Ww, Gg^Ve, Ww, Ch, Ww, Gs^Fp, Gs^Fp, Gs^Fp, Ss, Ss, Hh, Hh, Gg, Hh, Ss, Ss
Ss, Gs^Fp, Gs^Fp, Gs^Fp, Ss, Gs^Fp, Ss, Ss, Ss, Ss, Gg, Ss, Hh, Mm, Mm, Mm, Mm, Mm, Mm, Mm, Mm, Mm, Mm, Mm, Hh, Ss, Gs^Fp, Ww, Ww, Ww^Bw|, Ww, Ww, Gs^Fp, Ss, Ss, Ss, Ss, Hh, Hh, Ss^Vhs, Ss, Ss
Ss, Ss, Ss, Ss, Ss, Ss, Ss, Ss, Ss, Gg, Ss, Ss, Hh, Mm, Mm, Mm, Mm, Mm, Mm, Mm, Mm, Mm, Mm, Mm, Ss, Ss, Gs^Fp, Ww, Ww^Bw/, Ch, Ww, Ww, Ss, Ss, Ss, Ss, Ss, Ss, Ss, Ss, Ss, Ss
Ss, Ss, Ss, Ss, Ss, Ss, Ss, Ss, Ss, Gg, Ss, Ss, Ss, Hh, Hh, Mm, Mm, Mm, Mm, Mm, Mm, Mm, Mm, Hh, Ss^Vhs, Ss, Gs^Fp, Re, Ww, Ww, Wo, Ww, Ww, Ss, Gs^Fp, Ss, Ss, Ss, Ss, Ss, Ss, Ss
Gg, Ss^Vhs, Ss, Ss, Ss, Ss, Ss, Ss^Vhs, Ss, Ss, Ss, Ss, Ss, Ss^Vhs, Ss, Hh, Hh, Mm, Mm, Mm, Mm, Mm, Mm, Hh, Ss, Ss, Gs^Fp, Re, Gs^Fp, Gs^Fp, Ww, Wo, Ww, Ss^Vhs, Gs^Fp, Gs^Fp, Ss, Ss, Ss, Ss, Ss, Ss
Gg, Gg, Gg, Ss, Ss, Ss, Ss, Gg, Ss, Ss, Ss, Ss, Ss, Ss, Ss, Ss, Ss, Hh, Hh, Mm, Mm, Mm, Mm, Hh, Hh, Ss, Ss, Re, Ss, Ss, Ww, Wo, Ww, Ww, Ww, Gs^Fp, Ss, Ss, Ss, Ss, Ss, Gs^Fp
Gg, Gg, Gg, Gg, Ss, Ss, Ss, Gg, Ss, Ss, Ss, Ss, Ss, Ss, Ss, Ss, Ss, Ss, Ss, Hh, Mm, Mm, Mm, Hh, Hh, Ss, Ss, Ww^Bw|, Ss, Ss, Ww, Wo, Wo, Ww, Ww, Ww, Gs^Fp, Ss, Ss, Ss, Ss, Gs^Fp
Gg, Gg, Gg, Gg, Ss, Ss, Ss, Gg, Ss, Ss, Ss, Ss, Ss, Ss, Ss, Ss, Ss, Ss, Ss, Ss, Hh, Hh, Mm, Mm, Hh, Ss, Ss, Ww^Bw|, Ss, Ss, Ww, Wo, Ww, Ww, Ww, Wo, Ww, Ww, Gg^Ve, Ww, Ww, Gs^Fp
Gg, Gg, Gg, Gg, Gg, Gg, Gg, Gg, Ss, Hh, Ss, Ss, Gs^Fp, Gs^Fp, Ss, Ss, Ss, Gs^Fp, Gs^Fp, Ss, Ss, Hh, Hh, Hh, Ss, Ss, Ss, Ch, Ch, Ss^Vhs, Ww, Ww, Ww, Ww, Ww, Ww, Ww, Ww, Ww, Ww, Ww, Gs^Fp
Gg, Gg, Ss, Ss, Ss, Gg, Gg, Gg, Gg, Ss, Ss, Ss, Ss, Gs^Fp, Gs^Fp, Ss, Ss, Gs^Fp, Gg^Ve, Gs^Fp, Ss, Ss, Ss, Ss, Ss, Ss, Ss, Ss, Re, Ww, Ww, Ss, Gs^Fp, Gs^Fp, Gg^Ve, Ww, Ww, Ww, Gs^Fp, Gs^Fp, Gs^Fp, Gs^Fp
Gg, Gg, Ss, Ss, Ss, Ss, Ss, Gg, Ss^Vhs, Ss, Ss, Ss, Ss, Gs^Fp, Gs^Fp, Ss, Gs^Fp, Gs^Fp, Gs^Fp, Gs^Fp, Ss, Ss, Ss, Ss, Ss, Ss, Ww^Bw/, Re, Gg, Ww, Ss, Ss, Ss, Gs^Fp, Gs^Fp, Gs^Fp, Gs^Fp, Gs^Fp, Gs^Fp, Gs^Fp, Gs^Fp, Gs^Fp
Gg, Gg, Ss, Ss, Ss, Ss, Ss, Gg, Ss, Ss, Ss, Ss, Ss, Ss, Ss, Ww, Ww, Ww, Gs^Fp, Gs^Fp, Gs^Fp, Ss, Ss, Ss, Re, Ww^Bw/, Ss, Ss, Ww, Ss, Ss, Gs^Fp, Ss, Gs^Fp, Gs^Fp, Gs^Fp, Ss, Gs^Fp, Ss, Ss, Ss, Ss
Gg, Gg, Ss, Ss, Ss, Ss, Ss, Gg, Gg, Ss, Ss, Gg, Gg, Ss, Ss, Ww, Ww, Gs^Fp, Gs^Fp, Gs^Fp, Gs^Fp, Gs^Fp, Ww^Bw/, Re, Gg, Gg, Gg^Ve, Ss, Ss, Ss, Ss, Gs^Fp, Gs^Fp, Gs^Fp, Ss, Ss, Ss, Ss, Gg, Gg, Ww, Ss
Ss, Gg, Ss^Vhs, Ss, Ss, Gs^Fp, Ww, Ss, Gg, Gg, Gg, Gg, Gg, Ss, Ss, Ss^Vhs, Ww, Ss, Gs^Fp, Gs^Fp, Gs^Fp, Re, Ww, Ww, Ww, Ww, Ww, Ss, Ss, Ss, Ss, Gs^Fp, Gs^Fp, Gs^Fp, Ss, Ss, Ss, Ss, Ss, Ww, Ww, Ww
Ww, Ww, Ww, Ww, Gs^Fp, Ww, Ww, Ww, Ww, Gg, Gg, Gg, Ss, Ss, Ww, Ss, Ss, Ss, Ww, Ww, Re, Re, Ww, Ww, Ww, Ww, Ww, Ss, Ss, Gs^Fp, Gs^Fp, Gs^Fp, Gs^Fp, Ss, Ss, Ss, Ss, Ss, Ss, Ss, Ss, Ss
Ww, Wo, Ww, Ww, Ww, Ww, Ww, Ww, Ww, Ww, Gg, Ss, Ww, Ww, Ww, Ww, Ss, Ww, Ww, Ss, Ch, Ss, Gg^Ve, Ww, Ww, Ss, Ss, Ss, Gs^Fp, Gs^Fp, Gs^Fp, Gs^Fp, Ss, Ss, Ss, Ww, Ss, Ss, Gs^Fp, Gs^Fp, Ss, Ss
Wo, Wo, Ww, Ww, Ww, Ww, Ww, Ww, Ww, Ss, Ss, Ss, Ww, Ww, Ww, Ss, Ww^Bw/, Ch, Re, Re, Gg, Gg, Gg, Gg, Ss, Ss, Ss, Ss, Gs^Fp, Gs^Fp, Gs^Fp, Ss, Ss, Ss, Ss, Ss, Ss, Gs^Fp, Gs^Fp, Gs^Fp, Gs^Fp, Gs^Fp
Ww, Wo, Wo, Wo, Wo, Wo, Ww, Ww, Ww, Ww, Ss, Ss, Ss, Ww, Gg, Ch, Ww, Ss, Ss, Ss, Ss, Ss, Gg, Ss, Ss, Ss, Ss, Gs^Fp, Gs^Fp, Gs^Fp, Gs^Fp, Gs^Fp, Ss, Ss, Ss, Ss, Ww, Ww, Ww, Ww, Gg^Ve, Gs^Fp
Ww, Ww, Ww, Ww, Wo, Wo, Ww, Ww, Ww, Gs^Fp, Ss, Ss, Gg, Gg, Re, Re, Ss^Vhs, Ss, Ss, Ss, Ss, Ss, Gg, Gg, Ss, Ss, Ss, Gs^Fp, Gs^Fp, Gs^Fp, Gs^Fp, Gs^Fp, Gs^Fp, Ss, Ss, Ss, Ww, Ww, Ww, Ww, Ww, Ww
Ww, Ww, Ww, Ww, Wo, Ww, Ww, Ss^Vhs, Ss, Gs^Fp, Ch, Ss, Re, Re, Gg, Gg, Gg, Ss, Ss, Ss, Ss, Ss, Gg, Ss, Ss, Ss, Gs^Fp, Gs^Fp, Gs^Fp, Gs^Fp, Gs^Fp, Gs^Fp, Gs^Fp, Gs^Fp, Gs^Fp, Ss^Vhs, Ww, Ww, Ww, Ww, Ww, Ww
Gs^Fp, Gg^Ve, Ww, Ww, Ww, Ss, Ss, Ss, Ss, Ch, Ss, Ch, Gg, Gg, Gg, Gg, Gg, Ss, Ss, Ss, Ss, Ss, Gg, Ss, Ss, Ss, Gs^Fp, Gg^Ve, Gs^Fp, Gs^Fp, Gs^Fp, Gs^Fp, Gs^Fp, Gs^Fp, Ss, Ww, Ww, Ww, Ww, Wo, Ww, Ww
Gs^Fp, Gs^Fp, Gs^Fp, Gs^Fp, Ss, Gg, Ss, Ss, Ww^Bw/, Ch, Ss, Ss, Ss, Ss, Ss, Ss, Gg, Ss, Ss, Ss, Ss, Hh, Gg, Ss, Ss, Ss, Ss, Gs^Fp, Gs^Fp, Gs^Fp, Gs^Fp, Gs^Fp, Gs^Fp, Gs^Fp, Ww, Ww, Ww, Ww, Ww, Ww, Ww, Ww
Gs^Fp, Gs^Fp, Gs^Fp, Ss, Ss, Gg, Re, Ww^Bw/, Ss, Ss, Gs^Fp, Gs^Fp, Ss, Ss, Ss, Ss, Ss, Ss, Ss, Ss, Hh, Hh, Hh, Ss, Ss, Ss, Ss, Gs^Fp, Gs^Fp, Gs^Fp, Gs^Fp, Ww, Ww, Ww, Ww, Ww, Ww, Ww, Ww, Ww, Ww, Ww
Ss, Ss, Ss, Ss, Ss, Re, Ss, Ss, Ss, Gs^Fp, Gs^Fp, Gs^Fp, Gs^Fp, Ss, Ss, Ss, Ss, Ss, Ss, Ss^Vhs, Ss, Hh, Gg, Ss, Ss, Ss, Gs^Fp, Gs^Fp, Gg^Ve, Gs^Fp, Gs^Fp, Ww, Ww, Ww, Ww, Ww, Ww, Ww, Ss, Ss, Gs^Fp, Gs^Fp
Gg, Ss, Ss, Ss, Ss, Ww^Bw|, Ss, Ss, Ss, Gs^Fp, Gs^Fp, Gs^Fp, Gs^Fp, Gs^Fp, Ss, Ss, Ss, Ss, Ss, Ss, Ss, Ss, Gg, Ss, Ss, Ss, Ss, Gs^Fp, Gs^Fp, Gs^Fp, Ss, Ww, Ww, Wo, Ww, Ww, Ss, Ss, Ss, Ss, Gs^Fp, Gs^Fp
Gg, Gg, Ss, Ss, Ch, Ch, Ss, Ss, Gs^Fp, Gs^Fp, Gs^Fp, Gs^Fp, Gs^Fp, Ss, Ss, Ss, Ss, Ss, Ss, Ss, Ss, Ss, Ss, Ss, Ss, Ss, Gs^Fp, Ss, Gs^Fp, Gs^Fp, Ss, Ww, Ww, Ww, Ww, Ss, Ss^Vhs, Ss, Ss, Gs^Fp, Gs^Fp, Gs^Fp
Gg, Gg, Ss, Ch, Ch, Ch, Ss, Ss, Gs^Fp, Gg^Ve, Gs^Fp, Gs^Fp, Gs^Fp, Ss^Vhs, Ss, Ss, Ss, Ss, Gg, Ss, Ss, Ss, Ss, Ss, Ss, Ss, Ss, Ss, Ss, Gs^Fp, Gs^Fp, Ss, Ss, Ss, Gs^Fp, Gs^Fp, Ss, Ss, Ss, Ss, Ss, Ss
Gg, Ss, Ss, Ch, 1 Kh, Ch, Ss, Gs^Fp, Gs^Fp, Gs^Fp, Gs^Fp, Gs^Fp, Gs^Fp, Ss, Ss, Ss, Gg, Gg, Gg, Ss, Gg, Gg, Ss, Ss, Ss, Ss, Ss, Ss, Ss, Ss, Gs^Fp, Ss, Ss, Gs^Fp, Gg^Ve, Gs^Fp, Ss, Ss, Ss, Ss, Ss, Ss
Ss, Ss, Ch, Ch, Ch, Ss, Ss, Gs^Fp, Gs^Fp, Gs^Fp, Gs^Fp, Gs^Fp, Gs^Fp, Ss, Ss, Gg, Gg, Gg, Gg, Gg, Gg, Gg, Ss, Hh, Hh, Hh, Hh, Hh, Ss, Ss, Ss, Ss, Gs^Fp, Gs^Fp, Gs^Fp, Gs^Fp, Ss, Ss, Ss, Ss, Ss, Ss
Ss, Hh, Hh, Hh, Ss, Ss, Ss, Gs^Fp, Gs^Fp, Gs^Fp, Gs^Fp, Gs^Fp, Gs^Fp, Ss, Gg, Gg, Gg, Gg, Gg, Gg, Ss, Gg, Ss, Ss, Hh, Hh, Hh, Hh, Hh, Ss, Ss, Gs^Fp, Gs^Fp, Ss, Ss, Ss, Gs^Fp, Ss, Ss, Ss, Ss, Ss
Ss, Ss, Ss, Ss, Ss, Ss, Ss, Gs^Fp, Gs^Fp, Gs^Fp, Ss, Ss, Ss, Ss, Ss, Ss, Gg, Gg, Gg^Ve, Gg, Ss, Gg, Ss, Ss, Hh, Mm, Hh, Hh, Hh, Hh, Ss, Ss, Ss, Ss, Ss, Gs^Fp, Gs^Fp, Gs^Fp, Ss, Ss, Ss, Ss
Ss, Ss, Ss, Ss, Ss, Ss, Ss, Gs^Fp, Gg^Ve, Gs^Fp, Ss, Ss, Ss, Ss, Ss, Ss, Gg, Gg, Gg, Gg, Gg, Gg, Gg, Hh, Hh, Mm, Mm, Mm, Hh, Hh, Ss, Ss, Ss, Ss, Gs^Fp, Gs^Fp, Gg^Ve, Gs^Fp, Gs^Fp, Ss, Ss, Ss
Ss, Ss, Ss, Ss, Ss, Ss, Ss, Gs^Fp, Gs^Fp, Gs^Fp, Ss, Ss, Ss, Ss, Ss, Ss, Gg, Gg, Gg, Gg, Ss, Gg, Hh, Mm, Mm, Mm, Mm, Mm, Mm, Mm, Hh, Ss, Ss, Ss, Ss, Gs^Fp, Gs^Fp, Gs^Fp, Gs^Fp, Ss, Ss, Ss
