Ss, Ss, Ss, Ss, Ss, Ss, Ss, Ss, Ss, Ss, Ww, Ss, Ss, Ss, Ss, Ss, Ss, Gs^Fp, Gs^Fp, Gs^Fp, Gs^Fp, Ww, Ss, Ss, Ss, Ss, Gg, Gg, Gg, Gg, Ss, Ss, Ss, Ss, Ss, Gg, Gg, Ss, Ss, Ss, Ss, Ss
Ss, Ss, Ss, Ss, Ss, Ss, Gs^Fp, Ss, Ww, Ww, Ss, Ss, Ss, Ss, Ss, Ss, Ss, Ss, Gs^Fp, Gs^Fp, Gs^Fp, Ss^Vhs, Ww, Ss, Ss, Ss, Gg, Gg, Gg, Gg, Ss, Ss, Ss, Ss, Ss, Ss, Ss, Ss, Ww, Ss, Ss, Ss
Ss, Ss, Ss, Ss, Ss, Ss, Gs^Fp, Ss^Vhs, Ww, Ww, Ss, Ss, Hh, Mm, Hh, Hh, Hh, Ss, Ss, Ss, Gs^Fp, Ss, Ww, Ww, Ww, Ss, Gg, Gg, Gg, Gg, Ss, Ss, Ss, Ss, Ss, Ss, Ss, Ss, Ss, Ss, Gg, Gg
Ww, Ss, Ss, Ss, Ss, Ss, Ww, Ww, Ss, Ss, Ss, Ss, Hh, Mm, Mm, Mm^Vhh, Mm, Mm, Hh, Ss, Ss, Ss, Ww, Ww, Ww, Ww, Gg^Ve, Gg, Gg, Gg, Ss, Hh, Hh, Hh, Ch, Ch, Ch, Ss, Ss, Ss, Gg, Gg
Ww, Ww, Ss, Ss^Vhs, Ww, Ww, Ww, Ss, Ss, Ss, Ss, Ss, Hh, Mm, Mm, Mm, Mm, Mm, Hh, Ss, Ss, Ss, Ss, Ww, Ww, Ww, Ww, Gg, Gg, Ss, Ss, Hh, Hh, Hh, Ch, 2 Kh, Ch, Ss, Ss, Ss, Gg, Gg
Ss, Ww, Ww, Ww, Ww, Ww, Ww, Ss, Ss, Ss, Ss, Ss, Hh, Mm, Mm, Mm, Mm, Mm, Mm, Hh, Ss, Ss, Ss, Ww, Ww, Ww, Ss, Ss, Ss, Ss, Hh, Hh, Hh, Ch, Ch, Ch, Ss, Ss, Ss, Ss, Gg, Ww
Ww, Ss, Ss, Ss, Ww, Ss, Ww, Gg, Ss, Ss, Ss, Ss, Hh, Mm, Mm, Mm, Mm, Mm, Mm, Mm, Hh, Ss, Ss, Ss, Ww, Ss, Ss, Ss, Ss, Ss, Ss, Hh, Ss, Ss, Ss^Vhs, Ww^Bw|, Ss, Ss, Ww, Ww, Ww, Ww
Ww, Ss, Ss, Ww, Ww, Gg, Ww, Gg, Ss, Ss, Ss, Ss, Hh, Hh, Hh, Mm, Mm, Mm, Mm, Mm, Hh, Ss, Ss, Ss, Ss, Ss, Ss, Ss, Ss, Ss, Ss, Ss, Ss, Gg, Re, Re, Gg, Ww, Ww, Ww, Ww, Ww
Ww, Ss, Ss, Ww, Ss, Ww, Ww, Ss, Ss, Ss, Ss, Ss, Ss, Gg, Hh, Hh, Hh, Mm, Mm, Hh, Hh, Ss, Ss, Ss, Ss, Ss, Ss, Ss, Ss, Ss, Ss, Ss, Ss, Gg, Re, Ww, Ww, Wo, Wo, Wo, Ww, Ww
Ww, Ww, Ww, Ww, Ss, Ww, Ww, Ss, Ss, Ss, Ss, Ss, Ss, Gg, Gg, Gg, Ss, Ww, Ww, Ww, Ww, Ss^Vhs, Ss, Ss, Ww, Ss, Ss, Ww, Ww, Ss, Ss, Ss, Ss, Gg, Ww^Bw|, Ww, Ww, Ww, Ww, Ww, Ww, Ww
Hh, Ww, Ww, Ww, Gg, Gg, Ss, Ss, Ss, Ss, Ss, Gs^Fp, Ss, Ss, Ss, Ss, Ss, Ww, Ww, Ww, Ss, Ww, Ww, Ww, Ww, Ss^Vhs, Ss, Ww, Hh, Ww, Ww, Gg, Gg, Ww, Ww^Bw|, Ww, Ww, Ww, Ww, Ww, Ww, Ww
Hh, Ss, Ss, Gg^Ve, Gg, Gg, Ss, Gs^Fp, Ss, Gs^Fp, Gs^Fp, Gs^Fp, Gs^Fp, Ss, Ss, Ss, Ss, Ww, Ww, Ww, Ww, Ss, Ss^Vhs, Ww, Gg, Ww, Hh, Ww, Hh, Ss, Ss, Ww, Gg, Ww, Re, Ss, Ss, Ss^Vhs, Ss, Ww, Ss, Ss
Hh, Hh, Ss, Ss, Ss, Ss, Ss, Gs^Fp, Ss, Ss, Gg^Ve, Gs^Fp, Gg^Ve, Gs^Fp, Gs^Fp, Gs^Fp, Ss, Gs^Fp, Gs^Fp, Gs^Fp, Ss, Ss, Ss, Ss, Hh, Ww, Ww, Ww, Hh, Ss, Ss, Ww, Ww, Ww, Re, Ss, Gs^Fp, Gs^Fp, Gs^Fp, Gs^Fp, Ss, Ss
Hh, Ss, Ss, Ss, Ss, Ss, Ss, Gs^Fp, Gs^Fp, Gs^Fp, Gs^Fp, Gs^Fp, Gs^Fp, Gs^Fp, Ww, Gs^Fp, Gs^Fp, Gs^Fp, Gs^Fp, Ss, Ss, Ss, Ss, Hh, Hh, Mm^Vhh, Ww, Ww, Hh, Ss, Ss, Gg, Gg, Gg^Ve, Re, Ss, Gs^Fp, Gs^Fp, Gs^Fp, Ss, Ss, Ss
Ss, Ss, Ss, Ss, Ss, Ss, Ss, Ss, Gs^Fp, Gg^Ve, Gs^Fp, Gs^Fp, Ww, Ww, Ww, Ww, Ww, Ww, Ww, Ss, Ss, Ss, Gg, Hh, Hh, Mm, Mm, Ww, Hh, Ss, Ss, Gg, Re, Re, Gg, Ss, Ss, Ss, Ss, Ss, Ss, Ss
Ww^Bw|, Ss, Gs^Fp, Gs^Fp, Ss, Ss, Ss, Ww, Ww, Ww, Gs^Fp, Gs^Fp, Ww, Ww, Ww, Ww, Ww, Ww, Gs^Fp, Gs^Fp, Ss, Ss, Ss, Hh, Hh, Mm, Hh, Hh, Hh, Ss, Gg, Gg, Re, Gg, Ss, Ss, Ss, Ss, Ss, Ss, Ss, Ss
Ch, Ss, Ss, Ss, Ss, Ss, Gg, Ww, Ww, Ww, Ww, Ww, Ww, Ww, Ww, Wo, Wo, Ww, Ww, Ss, Ss, Ss, Ss, Hh, Mm, Hh, Hh, Hh, Ss, Ss, Gg, Gg, Re, Gg, Ss, Ss, Ss, Ss, Ss, Gg, Ss, Ss
Ss, Ch, Ss, Ss, Ss, Ss, Ss, Ww, Ww, Ww, Ww, Ww, Ww, Ww, Ww, Wo, Wo, Ww, Ww, Ss, Gs^Fp, Ss, Ss, Hh, Mm, Mm, Hh, Hh, Re, Ss, Re, Re, Gg, Ss, Ss, Ss, Ss, Gg, Ss, Ss, Ss, Gs^Fp
Ss, Re, Ss, Ss, Ss, Ss, Gg^Ve, Ww, Ww, Gs^Fp, Ww, Ww, Ww, Ww, Ww, Wo, Wo, Wo, Ww, Ss, Ss, Ss, Gg, Hh, Mm, Mm, Re, Re, Hh, Ch, Ch, Ss, Ss, Ss, Ss, Ss, Ss, Ss, Ss, Ss, Ss, Gs^Fp
Gg, Re, Ss, Ss, Ss, Ss, Ww, Gg, Ss, Ss, Gs^Fp, Gs^Fp, Gs^Fp, Gg^Ve, Gs^Fp, Ww, Wo, Ww, Ww, Ss, Ss, Gg, Gg, Hh, Re, Re, Hh, Hh, Hh, Ss, Ch, Ss, Ss, Ss, Ss, Ss, Ss, Ss, Ss, Ss, Gs^Fp, Gs^Fp
Ss, Ch, Ww^Bw\, Ss, Ss, Ss, Gg, Gg, Ss, Ss, Ss, Ss, Gs^Fp, Gs^Fp, Gs^Fp, Ss, Ww, Ww, Gg, Gg, Gg, Gg, Re, Re, Hh, Mm, Mm, Mm, Hh, Hh, Ss, Ww^Bw\, Ww^Bw\, Ss, Ss, Ss, Ss, Ss, Ss, Ss, Ss, Gs^Fp
Ss, Ss, Ss, Ch, Gg, Ss, Ss, Ss, Ss, Ss, Ss, Ss, Ss, Ss, Ss, Ss, Ww, Ss, Gg, Gg, Re, Re, Gg, Hh, Mm, Mm, Mm, Mm, Mm, Hh, Ss^Vhs, Ss, Gs^Fp, Ww^Bw\, Re, Ss, Ss, Ss, Ss, Ss, Ss, Ss
Ss, Hh, Hh, Re, Re, Ss, Ss, Ss, Ss, Ss, Ss, Ss, Ss, Ss, Ss, Ss, Gg, Gg, Re, Re, Gg, Gg^Ve, Gg, Hh, Mm, Mm, Mm, Mm, Mm, Hh, Ss, Ss, Gs^Fp, Ss, Re, Gs^Fp, Gs^Fp, Ss, Ss, Gg, Ss, Ss
Hh, Mm, Mm, Hh, Ss, Ww^Bw\, Re, Gs^Fp, Ss, Ss, Ss, Ss, Ss, Ss, Ss, Gg, Re, Re, Gg, Gg, Gg, Gg, Gg, Hh, Hh, Mm, Mm, Mm, Hh, Ss, Ss, Ss, Ss, Ss, Re, Gg^Ve, Gs^Fp, Ss, Ss, Gg, Gg, Gg
Mm, Mm, Hh, Hh, Ss, Gs^Fp, Gs^Fp, Re, Re, Gs^Fp, Ss, Ss, Ss, Ss, Ss, Gg, Re, Ss, Ss, Ss, Ss, Ss, Gg, Hh, Mm, Mm, Mm, Mm, Hh, Ss, Ss, Ss, Ss, Ss, Ss, Re, Re, Ss^Vhs, Ss, Gg, Gg, Gg
Mm, Hh, Hh, Ss, Ss, Gs^Fp, Gg^Ve, Gs^Fp, Gs^Fp, Re, Gs^Fp, Ss, Ss, Ss, Ss^Vhs, Re, Ss, Ss, Ss, Ss, Ss, Ss, Ss, Hh, Mm, Mm, Mm, Mm, Hh, Ss, Ss, Ss, Ss, Ss, Ss, Ss, Ss, Re, Ch, Re, Re, Gg
Ss, Gg, Ss, Ss, Ss, Gs^Fp, Gs^Fp, Gg^Ve, Gs^Fp, Re, Gs^Fp, Ww, Ww, Ww, Ww, Re, Ss, Ss, Gs^Fp, Gs^Fp, Gs^Fp, Gs^Fp, Ss, Hh, Mm, Mm, Mm, Mm, Hh, Ss, Ss, Ss, Ss^Vhs, Ss, Ss, Ss, Ss, Ss, Ss, Ss, Gg, Re
Ss, Ss, Ss, Ss, Gs^Fp, Gs^Fp, Gs^Fp, Gs^Fp, Gs^Fp, Re, Ww, Ww, Ww, Ww, Ss, Re, Ss, Ss, Gs^Fp, Gg^Ve, Gs^Fp, Gs^Fp, Ss, Hh, Mm, Mm, Mm, Mm, Hh, Ss, Ss, Ss, Ss, Ss, Ss, Ss, Ss, Gs^Fp, Ss, Ss, Ss, Ss
Gs^Fp, Ss, Ss, Ss, Gs^Fp, Gs^Fp, Gs^Fp, Gs^Fp, Ss, Ch, Re, Gs^Fp, Gs^Fp, Gs^Fp, Ss, Ww^Bw|, Ss, Ss, Gs^Fp, Gs^Fp, Gs^Fp, Gs^Fp, Ss, Ss, Mm, Mm, Mm, Mm, Mm, Hh, Ss, Ss, Ss, Ss, Ss, Ss, Ss, Ss, Ss, Ss, Ss, Ch
Gs^Fp, Ss, Ss, Ss, Ss, Ss, Gs^Fp, Gs^Fp, Ss, Ss, Ss, Ww^Bw\, Re, Gs^Fp, Re, Ch, Ss, Gs^Fp, Ss, Ss, Ss, Ss, Ss, Ss, Hh, Mm, Mm, Mm, Mm, Hh, Hh, Ss, Ss, Gs^Fp, Ss, Ss, Ss, Ss, Ss, Ss, Ss, Ww^Bw|
Ww, Ss, Ss, Ss, Ss, Ss, Ss, Ss, Ss, Ss, Ss, Ss, Gs^Fp, Re, Gs^Fp, Ss, Ss, Ss, Ss, Ss, Ss, Ss, Gg, Gg, Ss, Hh^Vhh, Mm, Mm, Mm, Mm, Hh, Hh, Ss, Ss, Gs^Fp, Ss, Ss, Hh, Hh, Ss, Ss^Vhs, Re
Ww, Ss^Vhs, Ss, Ss, Ss, Ss, Ss, Ss, Re, Gg, Ss, Ww, Ww^Bw/, Re, Re, Gs^Fp, Ss, Ss, Ss, Gg, Gg, Gg, Gg, Ss, Ss, Hh, Hh, Mm, Mm, Mm, Hh, Hh, Ss, Ss, Ss, Ss, Hh, Hh, Hh, Hh, Hh, Re
Ww, Ss, Ss, Ss, Gg, Gg, Re, Re, Gg, Re, Re, Re, Ss, Ss, Ww^Bw|, Ss, Ss, Ss, Gg, Gg, Gg, Gg, Ss, Ss, Ss, Ss, Hh, Hh, Hh, Hh, Hh, Gg, Ss, Ss, Ss, Hh, Mm, Mm, Mm, Hh, Hh, Hh
Ss, Ss, Ss, Ss, Gg, Gg, Re, Gg, Gg, Ww, Gg, Gg, Gg, Ss, Ch, Ss, Ss, Ss, Gg^Ve, Gg, Ww, Gg, Ss, Ss, Ss, Ss, Ss, Ss, Ss, Gg, Gg, Gg, Ss^Vhs, Ss, Hh, Hh, Mm, Mm, Mm, Mm, Hh, Ss
Ss, Ss, Ss, Gg, Gg, Ss, Re, Gg, Gg, Gg^Ve, Ww, Gg, Ss, Ss, Ss, Ch, Ss, Ss, Gg, Ww, Ww, Ww, Ss, Ss, Ss, Ss, Ss, Ss, Gg, Gg, Gg, Ss, Ss, Ss, Hh, Mm, Mm, Mm, Mm, Mm, Hh, Ss
Gs^Fp, Ss, Ss, Ch, Ch, Ch, Re, Gg, Ww, Ww, Gg^Ve, Ss, Ss, Ss, Ss, Ww^Bw|, Ss, Ss, Gg, Gg^Ve, Ww, Ww, Ww, Ww, Ss, Ss, Ss, Ss, Gg, Gg, Gg, Ss, Hh, Hh, Mm, Mm, Mm, Mm, Mm, Mm, Hh, Ss
Gs^Fp, Ss, Ss, Ch, 1 Kh, Ch, Gg, Gg, Ww, Ww, Gg, Ss, Ss, Ss, Ss, Re, Ss, Ss, Ss, Ss, Ww, Ww, Ww, Ss, Ss, Ss, Ss^Vhs, Ss, Gg, Gg, Gg, Ss, Ss, Hh, Mm, Mm, Mm, Mm, Mm, Ss, Ss, Ss
Ss, Ss, Ch, Ch, Ch, Gg, Ss, Ss, Ss, Gg, Ss, Ss, Ss, Ss, Ss, Re, Ww^Bw\, Ss, Ss, Ss, Ww, Ww, Ww, Ss, Ss, Ss, Ss, Gg, Gg, Ss, Ss, Ss, Hh, Hh, Mm, Mm, Mm, Hh, Ss, Gs^Fp, Ss, Ss
Ss, Ss, Gg, Gg, Gg, Gg, Ss, Ss, Ss, Ss, Ss, Ss, Ss, Ss, Hh, Hh, Ss^Vhs, Ww^Bw\, Ch, Ss, Ss, Ww, Ss, Ss, Ss, Ss, Ss, Ss, Ss, Ss, Ss, Ss, Ss, Mm, Mm, Mm, Hh, Hh, Gs^Fp, Gs^Fp, Gs^Fp, Ss
Ss, Ss, Gg, Gg, Gg, Gg, Gg, Ss, Gs^Fp, Gs^Fp, Ss, Ss, Ss, Hh, Hh, Hh, Ss, Ss, Ww^Bw|, Ss, Ss, Ss, Ss, Gg, Gg, Gg, Gg, Gg, Ss, Ss, Ss, Ss, Hh, Hh, Hh, Hh, Hh, Hh, Gs^Fp, Gg^Ve, Gs^Fp, Gs^Fp
Gg, Gg, Gg, Gg, Gg, Gg, Gg, Ss, Ss, Ss, Ss, Ss, Hh, Hh, Hh, Hh, Hh, Ss, Ch, Ss, Ss, Ss, Ss, Gg, Gg, Gg, Gg, Gg, Ss, Ss, Ss, Ss, Ss, Ss, Hh, Hh, Hh, Hh, Gs^Fp, Gs^Fp, Gs^Fp, Gs^Fp
Gg, Gg, Gg, Gg, Gg, Gg, Gg, Ss, Ss, Ss, Ss, Gs^Fp, Ss, Hh, Hh, Hh, Ss, Ww^Bw/, Ss, Ss, Ss, Ss, Ss, Ss, Gg, Gg, Gg, Gg, Ss, Ss, Ss, Ss, Ss, Ss, Ss, Hh, Ss, Ss, Gs^Fp, Ss, Ss, Gs^Fp
