Hh, Hh, Mm, Mm, Mm, Mm, Mm, Mm, Mm, Hh, Hh, Ss, Ss, Ss, Ss, Ss, Gs^Fp, Gs^Fp, Gs^Fp, Gs^Fp, Ww, Ww, Ss, Ss, Ss, Ss, Ss, Ss, Ss, Ss, Ss, Ss, Ss, Ss, Ss, Ss, Ss, Ss, Ss, Ww, Gs^Fp, Gs^Fp
Ss, Hh, Mm, Mm, Mm, Mm, Mm, Mm, Mm, Mm, Hh, Ss, Ss, Ss, Ss, Ss, Ss, Ss, Gs^Fp, Gs^Fp, Gs^Fp, Gs^Fp, Ss, Ss, Ss, Ss, Ss, Ss, Ss, Ss, Gg, Ss, Ss, Ss, Ss, Ss, Ss, Gs^Fp, Gs^Fp, Ww, Gs^Fp, Re
Ss, Hh, Hh, Mm, Hh, Mm, Mm, Hh, Hh, Hh, Hh, Ss, Ss, Ss, Ss, Ss, Ss, Ss, Ss, Gs^Fp, Gs^Fp, Gs^Fp, Ww, Ss, Ss, Gg, Gg, Ss, Ss, Gg, Gg, Gg, Gg, Gg, Gg, Ss, Ss, Gs^Fp, Gs^Fp, Gg^Ve, Gs^Fp, Re
Gg, Ss, Ss^Vhs, Ss, Ss, Hh, Hh, Gg, Gg, Ss, Ss, Ss, Ss, Ss, Ss, Ss, Ss, Ss, Ss, Ss, Gs^Fp, Gg^Ve, Gs^Fp, Ss, Ss, Gg, Ss, Ss, Ss, Gg, Gg, Gg, Gg, Gg, Gg, Ch, Ch, Ch, Gs^Fp, Gs^Fp, Re, Re
Gg, Ss, Ss, Ss, Ss, Ss, Ss, Ss, Ss, Ss, Ss, Ss, Ss, Ss, Ss, Hh, Hh, Ss, Ss, Ss, Gs^Fp, Gs^Fp, Gs^Fp, Gs^Fp, Ss, Gg, Gg, Ss, Gg, Gg, Ss, Ss, Ss, Ss, Ss, Ch, 2 Kh, Ch, Ww^Bw/, Ww^Bw/, Ss, Gs^Fp
Gg, Gg, Ss, Ss, Ss, Ss, Ss, Ss, Ss, Ss, Ss, Ss, Ss, Ss, Ss, Ss, Gs^Fp, Ss, Ss, Ss, Gs^Fp, Gs^Fp, Gs^Fp, Ss, Ss, Ss, Ss, Ss, Ss, Gg, Ss^Vhs, Ss, Ss, Ss, Ch, Ch, Ch, Ch, Ss, Ss, Ss, Ss
Gg, Gg, Ss, Ss, Ss, Ss, Ss, Ss^Vhs, Ss, Ss, Ss, Ss, Ss, Ss, Ss, Ss, Gs^Fp, Gs^Fp, Gs^Fp, Ss, Gs^Fp, Gs^Fp, Gs^Fp, Gs^Fp, Ss, Ss, Ss, Ss, Gg, Ww, Ss, Ss, Ss, Ss, Ss, Re, Re, Re, Gg, Gg, Gg, Ss
Hh, Ss, Ss, Ss, Ss, Ss, Ss, Ss, Ss, Ss, Ss, Gg, Ss, Ss, Gs^Fp, Ss, Gs^Fp, Gs^Fp, Gs^Fp, Gs^Fp, Gs^Fp, Gs^Fp, Gs^Fp, Gs^Fp, Ss, Ss, Ss, Ss, Ss, Gg, Ss, Ss, Ss, Ss, Ch, Re, Gg, Gg, Gg, Ss, Gg, Gg
Gg, Ss, Ss, Ss, Gg, Gg, Gg, Gg, Gg, Gg, Gg, Ss, Ss, Ss, Gs^Fp, Gg^Ve, Ss, Ss, Gs^Fp, Ss, Ss, Ss, Ss, Ss, Gs^Fp, Gs^Fp, Gg^Ve, Ss, Ss, Gg, Ss, Ss, Ss, Ss, Ch, Ss, Ss, Ss, Ss, Ss, Ss^Vhs, Ss
Ss, Ss, Gg, Ss, Gg, Gg, Gg, Gg, Gg, Gg, Gg, Ss, Ss, Ss, Ss, Gs^Fp, Gs^Fp, Gs^Fp, Ss, Ss, Ss, Ss, Gg, Ss, Gs^Fp, Gs^Fp, Gs^Fp, Gs^Fp, Ss, Gg, Gg, Gg, Re, Re, Gg, Ss, Ss, Ss, Ss, Ss, Ss, Ww
Ss, Ss, Gg, Ss, Ss, Ss, Gg, Gg, Gg, Ss, Ss, Ss, Ss, Ss, Ss, Ss, Ss, Ss, Ss, Ss, Gg, Gg, Gg, Ss, Gs^Fp, Gs^Fp, Gs^Fp, Gs^Fp, Ss, Gg, Re, Re, Gg, Gg, Gg, Ss, Ss, Ss, Ss, Ss, Ss, Ss
Ss, Ss^Vhs, Ss, Ss, Ss, Ss, Gg, Gg, Ss, Ss, Ss, Ss, Ss, Ss, Ss, Gg, Ww, Ss, Ss^Vhs, Ss, Gg, Gg, Ss, Ss, Ss, Gs^Fp, Re, Gs^Fp, Ss, Gg, Re, Gg^Ve, Gg, Gg, Gg, Ss, Ss, Ss, Ss, Ss, Ss, Ss
Ss, Ss, Ss, Ss, Ss, Ss, Ss, Gg, Gg, Ss, Ss, Ss, Ss, Ss, Gg, Gg, Ww, Ww, Ss, Ss, Ss, Gg, Ss, Ss, Ww^Bw/, Ww^Bw/, Ss^Vhs, Ww^Bw\, Ch, Re, Hh, Hh, Gg, Ss, Ss, Ss, Ss, Ss, Ss, Ss, Ss, Gg
Ss, Ss, Ss, Ss, Ss, Ss, Ss, Gg, Gg^Ve, Gg, Ss, Ss, Ss, Ss, Ss, Gg^Ve, Ww, Ss, Ss, Ss, Ss, Gg, Re, Ww^Bw/, Ss, Ss, Ss, Ss, Ss, Gg, Hh, Hh, Gg, Ss, Ss, Ss, Ss, Ss, Ss, Ss, Ss, Ss
Ss, Ss, Ss, Ss, Ss, Ss, Ss, Gg, Gg, Gg, Gg, Gg, Ss, Ss, Ss, Ss, Ss, Gs^Fp, Gs^Fp, Ss, Ss, Re, Gg, Ss, Ss, Ss, Ss, Ss, Gg, Hh, Gg, Gg, Ss, Gs^Fp, Gs^Fp, Gs^Fp, Ss, Ss, Ss, Ss, Ss, Ss
Gs^Fp, Ss, Gs^Fp, Ss, Ss, Ss, Ss, Gg, Ss, Gg, Gg, Gg, Ss, Ss, Gs^Fp, Ss, Gs^Fp, Gs^Fp, Gs^Fp, Ss, Ss, Re, Ss, Ss, Ss, Ss, Ss, Ss, Hh, Gg, Gg, Gg, Ss, Gs^Fp, Gs^Fp, Ww, Ww, Ss, Ss, Ss, Ss, Ss
Gs^Fp, Gs^Fp, Gs^Fp, Gs^Fp, Ss, Ss, Ss, Ss, Ss, Gg, Gg, Gg, Ss, Gs^Fp, Gs^Fp, Gs^Fp, Gs^Fp, Ss, Ss, Ss, Ss^Vhs, Re, Ss, Ss, Ss, Ss, Hh, Hh, Ss, Gg, Ss, Ss, Ss, Gs^Fp, Ww, Ww, Ww, Ww, Ss^Vhs, Ss, Ss, Ss
Gs^Fp, Gs^Fp, Gs^Fp, Gs^Fp, Ss, Ss, Ss, Ss, Ss, Gg, Gg, Ss, Gs^Fp, Gs^Fp, Gs^Fp, Gs^Fp, Gs^Fp, Gs^Fp, Ss, Gg, Gg, Re, Gg, Ss, Ss, Ss, Hh, Hh, Ss, Gg, Ss, Ss, Ss, Ww, Ww, Ww, Ww, Ww, Ww, Ss, Ss, Ss
Gs^Fp, Gs^Fp, Ss, Gs^Fp, Ss, Ss, Ss, Ss, Ss, Ss, Gg, Ss, Gs^Fp, Gs^Fp, Gs^Fp, Gs^Fp, Gs^Fp, Ss, Ss, Gg, Gg, Re, Gg, Ss, Ss, Hh, Ss, Ss, Ss, Ss, Ss, Ss, Ww, Ww, Ww, Wo, Wo, Ww, Ww, Gg, Gg, Ss
Gs^Fp, Ss, Ss, Gs^Fp, Gs^Fp, Gs^Fp, Ss, Ss, Gg, Gg, Gg, Ss, Gs^Fp, Gs^Fp, Gs^Fp, Gs^Fp, Gs^Fp, Gs^Fp, Ss, Gg, Gg, Re, Ss, Ss, Ss, Ss^Vhs, Ss, Ss, Ss, Ss, Ss, Ss, Ww, Ww^Vm, Ww, Ww, Ww, Ww, Ww, Gg, Gg, Gg
Ss, Ss, Ss, Gs^Fp, Gs^Fp, Gs^Fp, Ss^Vhs, Ss, Gg, Gg, Gg, Ss, Ss, Gs^Fp, Gs^Fp, Gs^Fp, Gs^Fp, Gs^Fp, Ss, Gg, Gg, Re, Ss, Ss, Ss, Ss, Ss, Ss, Gg, Ss, Ss, Ss, Ww, Ww, Ww, Ww, Ww, Ww, Gg, Gg, Gg, Re
Ss, Ss, Gs^Fp, Gg^Ve, Gs^Fp, Ss, Ss, Ss, Gg, Gg, Gg, Ss, Ss, Ss, Ss, Gs^Fp, Ss, Ss, Ww, Gg, Gg, Re, Re, Ss, Ss, Ss, Ss, Ss, Gg, Gg, Ss, Gg, Ww, Ww, Ww, Ww, Ww, Ss, Gg, Gg, Gg, Re
Ss, Gs^Fp, Gs^Fp, Gs^Fp, Ss, Ss, Ss, Ss, Gg, Gg, Gg, Gg, Ss, Ss, Ss, Ss, Ww, Ww, Ww, Ww, Ww, Gg, Re, Gg, Ss, Ss, Ss, Ss, Ss, Ss, Gg, Gg, Gg, Ww, Ww, Ww, Ww, Ss, Ss, Ss, Ss, Ss
Ss, Ss, Ss, Ss, Ss, Ss, Ss, Gg, Gg, Gg, Gg, Gg, Gg, Gg, Ss^Vhs, Ww, Ww, Ww, Wo, Wo, Ww, Gg, Re, Ss, Ss, Ss, Ss, Ss, Ss, Ss, Gg, Gg, Gg, Ww, Ww, Ww, Ss, Ss^Vhs, Gg, Ss, Ss, Ss
Ss, Ss, Ss, Ss, Ss, Ss, Ss, Ss, Gg, Gg, Gg, Gg, Gg, Gg, Gg, Ww, Ww, Ww, Wo, Wo, Ww, Ww, Re, Ss, Ss, Ss, Ss, Ss, Ss, Ss, Ss, Gg, Ww, Wo, Wo, Ww, Ss, Gg, Ss, Ss, Ss, Ss
Ss, Gg, Ss, Ss, Ss, Ss, Ss, Ss, Ss, Gg, Gg, Gg, Gg, Gg, Gg, Gg, Ww, Ww, Ww, Wo, Ww, Ww, Ch, Ss, Ss, Ss, Ss, Ss, Gg, Ss, Ss, Gg, Ww, Wo, Wo, Ww, Gg, Gg, Ss, Ss, Ss, Ss
Gg, Gg, Gg, Ss, Ss, Ss, Ss^Vhs, Ss, Ss, Ss, Ss, Ss, Gg, Gg, Gg, Gg, Gg, Ww, Ww, Wo, Ww, Ch, Gs^Fp, Gs^Fp, Ss, Ss, Ss, Ss, Gg, Gg, Gg, Gg, Ww, Wo, Wo, Ww, Ww, Ss, Ss, Gs^Fp, Gs^Fp, Ss
Gg, Gg^Ve, Gg, Ss, Ss, Ss, Ss, Ss, Ss, Ss, Ss, Ss, Ss, Ss, Ss, Ss, Gg, Gg^Ve, Ww, Ww, Ss^Vhs, Re, Gs^Fp, Gs^Fp, Ss, Ss, Ss, Ss, Ss, Ss, Gg^Ve, Gg, Ww, Ww, Ww, Ww, Ww, Ss, Ss, Ss, Ss, Gs^Fp
Gg, Gg, Gg, Ss, Ss, Ss, Ss, Ss, Ss, Ss, Ss, Ss, Gs^Fp, Gs^Fp, Ss, Ss, Gg, Gg, Ww, Ww, Ss, Re, Gs^Fp, Gs^Fp, Ss, Ss, Ss, Ss, Ss, Ss, Ss, Ww, Ww, Ww, Ww, Ss^Vhs, Ss, Ss, Ss, Ss, Ss, Ss
Ss, Gg, Gg, Ss, Ss, Ss, Gg, Ss, Ss, Ss, Ss, Gs^Fp, Gs^Fp, Gs^Fp, Ss, Ss, Gg, Gg, Gg, Ss, Ww^Bw/, Re, Ss, Ss, Ss, Ss, Gg, Gg, Ss, Ss, Ss, Ss, Ww, Ww, Ww, Ss, Ss, Ss, Gs^Fp, Gs^Fp, Ss, Ss
Ss, Gg, Gg, Gg, Ss, Gg, Gg, Gg, Ss, Ss, Ss, Ss, Ss, Ss, Ss, Ss, Ss, Gg, Gg, Re, Ss, Ss, Ss, Ss, Ss, Ss, Gg, Gg, Ss, Ss, Ss, Ss, Ww, Ss, Ss, Ss, Ss, Ss, Ss, Gs^Fp, Ss, Ss
Ss, Ss, Ss^Vhs, Gg, Gg, Gg, Gg, Ss, Ss, Ss, Ss, Ss, Ss, Ss, Ss, Ss, Ss, Gg, Gg, Re, Ss, Ss, Ss, Ss, Gs^Fp, Ss, Ss, Ss, Ss, Ss, Ss, Ss, Ss, Ss, Ss, Ss, Ss, Ss, Ss, Ss, Gs^Fp, Gs^Fp
Ss, Ss, Ss, Ss, Gg, Gg, Gg, Ss, Ss, Ss, Ss, Ss, Gg, Gg, Ss, Ss, Ch, Ss, Re, Re, Ss, Ss, Ss, Gs^Fp, Ss, Ss, Ss, Ss, Ss, Ss, Ww, Ww, Ss, Ss, Ss, Ss, Ss, Ss, Ss, Ss, Gg^Ve, Gs^Fp
Ss, Ss, Ss, Ss, Ss, Ss, Ss, Ss, Ss, Gg, Gg, Gg, Gg, Gg, Re, Re, Ss, Ch, Ss, Ss^Vhs, Ss, Ss, Gs^Fp, Gs^Fp, Gs^Fp, Ss, Ss, Ss, Ss, Ss, Ss, Ss^Vhs, Ss, Ss, Ss, Ss, Gs^Fp, Ss, Ss, Gs^Fp, Gs^Fp, Re
Gs^Fp, Ss, Ss, Ss, Ss, Ss, Ss, Ss, Gg, Gg, Gg, Gg, Re, Re, Gg^Ve, Gg, Ss, Ss, Ss, Ss, Ss, Gs^Fp, Ss, Gs^Fp, Ss^Vhs, Ss, Ss, Ss, Gg, Gg, Gg, Ss, Ss, Ss, Ss, Ss, Gs^Fp, Gs^Fp, Gs^Fp, Gs^Fp, Gs^Fp, Re
Ss, Ss, Gs^Fp, Ch, Ch, Ch, Ss, Ss, Ww^Bw/, Re, Re, Re, Gg, Gg, Gg, Gg, Gg, Ss, Ss, Ss, Ww, Ww, Ss, Ss, Ss, Ss, Ss, Gg, Gg, Gg, Ss, Ss, Ss, Ss, Ss, Ss, Ss, Ss, Ss, Ss, Ch, Ch
Ss, Ss, Hh, Ch, 1 Kh, Ch, Ss, Re, Ss, Ss^Vhs, Re, Gg, Gg, Ss, Gg, Gg, Gg, Ss, Ss, Ww, Ww, Ww, Ss, Ss, Ss, Ss, Ss, Gg, Gg, Ss, Ss, Ss, Ss, Ss, Gs^Fp, Gs^Fp, Ss, Ss, Ss, Ss, Ww^Bw|, Ww
Gs^Fp, Ss, Ch, Ch, Ch, Ww^Bw\, Re, Re, Gs^Fp, Ss, Re, Gg, Gg, Gg, Gg, Gg, Ss, Ss, Ss, Ww, Ww, Ww, Gg, Ss, Ss, Ss, Ss, Ss, Gg, Ss, Ss, Ss, Ss, Gs^Fp, Gs^Fp, Gs^Fp, Ss, Ss, Ss, Ss, Ww^Bw|, Ss
Gs^Fp, Gs^Fp, Ss, Gs^Fp, Ss, Ss, Gs^Fp, Gs^Fp, Gs^Fp, Ss, Ss, Re, Re, Gg, Gg, Gg, Ss, Ss, Ss, Ww, Ww, Ww, Gg, Ss, Ss^Vhs, Ss, Ss, Hh, Hh, Gg, Ss, Ss, Ss, Gs^Fp, Gs^Fp, Gs^Fp, Gs^Fp, Gs^Fp, Gs^Fp, Ss, Re, Gg
Gs^Fp, Gs^Fp, Ss, Ss, Ss, Gs^Fp, Gs^Fp, Gs^Fp, Gs^Fp, Ss, Ss, Ss, Ww^Bw|, Ss, Ss, Ss, Ss, Ss, Ss, Ss^Vhs, Ww, Ss, Ss, Ss, Ss, Ss, Hh, Hh, Hh, Hh, Ss, Ss, Ss, Ss, Gs^Fp, Gs^Fp, Gs^Fp, Gs^Fp, Gs^Fp, Ss, Ss, Re
Gs^Fp, Gs^Fp, Ss, Ss, Gs^Fp, Gs^Fp, Gs^Fp, Ss, Ss, Ss, Ss, Gs^Fp, Ch, Ss, Ss^Vhs, Ss, Ss, Ss, Ss, Gs^Fp, Ss, Ss, Ss, Ss, Ss, Ss, Hh, Hh, Mm, Mm, Ss, Ss, Ss, Ss, Ss, Ss, Gs^Fp, Gs^Fp, Gs^Fp, Gs^Fp, Ss, Ww^Bw|
Gs^Fp, Ss, Hh, Hh, Ss, Ss, Ss, Ss, Ss, Ss, Ss, Gs^Fp, Gs^Fp, Ss, Ss, Ss, Ss, Ss, Gs^Fp, Gs^Fp, Gs^Fp, Gs^Fp, Gs^Fp, Gs^Fp, Ss, Ss, Ss, Hh, Hh, Hh, Ss, Gg, Gg, Gg, Ss, Ss, Ss, Gs^Fp, Gs^Fp, Ss, Ss, Re
