Ss, Ss, Hh, Mm, Mm, Mm, Mm, Mm, Hh, Hh, Ss, Ss, Ss, Ss, Ss, Ss, Ss, Gs^Fp, Gs^Fp, Gs^Fp, Gs^Fp, Gs^Fp, Gs^Fp, Ss, Hh, Mm, Mm, Mm, Re, Hh, Ss, Ss, Gg, Gg, Ss, Ss, Gs^Fp, Gs^Fp, Re, Re, Re, Ss
Ss, Hh, Mm, Mm, Mm, Mm, Mm, Mm, Mm, Hh, Ss, Ss, Ss, Ss, Ss, Ss, Ss, Ss, Ss, Gs^Fp, Gs^Fp, Gs^Fp, Gs^Fp, Ss, Hh, Mm, Mm, Mm, Mm, Re, Ww^Bw\, Ss, Ss, Ss, Ss, Ss, Re, Re, Gs^Fp, Gs^Fp, Gs^Fp, Ss
Gg, Hh, Mm, Mm, Mm, Mm, Mm, Mm, Mm, Hh, Ss, Gg, Gg, Ss^Vhs, Ss, Ss, Ss, Ss, Ss, Gs^Fp, Gs^Fp, Gs^Fp, Gs^Fp, Ss, Ss, Hh, Mm, Mm, Mm, Hh, Ss, Ww^Bw\, Ww^Bw\, Gs^Fp, Re, Re, Gs^Fp, Gs^Fp, Gg^Ve, Gs^Fp, Gs^Fp, Ss
Gg, Hh, Hh, Mm, Mm, Mm, Mm, Mm, Hh, Ss, Ss, Ss, Ss, Ss, Ss, Ss, Ss, Ss, Ss, Ss, Gs^Fp, Gg^Ve, Ss, Ss, Ss, Ss, Hh, Mm, Mm, Mm, Ss, Ss, Ch, Ch, Ch, Gs^Fp, Gg^Ve, Gs^Fp, Gs^Fp, Gs^Fp, Ss, Ss
Ss, Ss, Hh, Mm, Mm, Mm, Mm, Mm, Hh, Ss, Ss, Ss, Ss, Ss, Ss, Ss, Ss, Ss, Ss, Ss, Ss, Gs^Fp, Gs^Fp, Ss, Ss, Hh, Hh, Mm, Mm, Hh, Ss, Ss, Ch, 2 Kh, Ch, Ww, Ww, Gs^Fp, Gs^Fp, Gs^Fp, Ss, Ss
Ss, Ss, Hh, Hh, Hh, Hh, Hh, Hh, Ss, Ss, Gg^Ve, Gs^Fp, Gs^Fp, Gs^Fp, Ss, Ss, Ss, Ss, Ss, Ss, Ss, Ss, Ss, Ss, Ss, Hh, Mm, Mm, Mm, Hh, Ss, Ch, Ch, Ch, Gs^Fp, Ww, Ww, Gs^Fp, Gs^Fp, Ss, Ss, Ss
Ss, Ss^Vhs, Ss, Ss, Gg, Gg, Ss, Ss, Ss, Gs^Fp, Gs^Fp, Gs^Fp, Gs^Fp, Gs^Fp, Ss, Ss, Ss, Ss, Ss, Ss, Ss, Ss, Ss, Ss, Ss, Ss, Hh, Mm, Hh, Hh, Ww^Bw/, Ww^Bw/, Gs^Fp, Gs^Fp, Ww, Ww, Ww, Gs^Fp, Gs^Fp, Ss, Hh, Ss
Ss, Ss, Ss, Ss, Ss, Gg, Gg, Ss, Ss, Ss, Gs^Fp, Gs^Fp, Gs^Fp, Gs^Fp, Gs^Fp, Ss, Ss, Ss, Ss, Ss, Ss, Ss, Ss, Ss, Ss, Ss, Ss^Vhs, Hh, Re, Re, Ss, Ss, Ss, Gs^Fp, Ww, Ww, Ss, Ss, Ss, Ss, Hh, Hh
Ss, Ss, Ss, Ss, Ss, Gg, Gg, Ss, Ss, Ss, Gs^Fp, Gs^Fp, Gs^Fp, Gs^Fp, Gs^Fp, Ss, Ss, Ss, Ss, Ss, Ss, Gg, Ss, Ss, Ss, Ss, Ww, Re, Ww, Ww, Gg, Ss, Ww, Ww, Ss, Ss, Ss, Ss, Ss, Ss, Hh, Hh
Ss, Ss, Ss, Ss, Ss, Gg, Gg, Gg, Gg, Ss, Ss, Gs^Fp, Ww, Gg^Ve, Gs^Fp, Gs^Fp, Ss, Ss, Ss, Ss, Gg, Gg, Gg, Ss, Ww, Ww, Ss, Ww^Bw|, Ss, Ww, Ww, Ww, Ss^Vhs, Ww, Gg, Gg, Gg, Ss, Ss^Vhs, Ss, Hh, Hh
Ss, Ss, Ss, Ss, Ss, Ss, Gg, Gg, Gg, Ss, Ww, Ww, Ww, Ww, Ww, Ww, Gs^Fp, Ss, Ss, Ss, Ss, Ss, Ww, Ww, Ss, Ss, Ch, Ch, Ss, Ss, Ss, Ss, Ss, Ss, Ss, Gg, Ss, Ss, Ss, Ss, Ss, Ss
Ss, Ss, Ss, Ss, Ww, Ww, Ww, Ss, Ss, Ss, Ww, Ww, Gs^Fp, Gs^Fp, Ss, Ww, Ww, Ww, Ww, Ww, Ss^Vhs, Ww, Gs^Fp, Ss, Ss, Ss, Ch, Ss, Ss, Ss, Ss, Ss, Ss, Ss, Ss, Ss, Ss, Ss, Ss, Ss, Ss, Ss
Re, Ss, Ss, Ss^Vhs, Ww, Ww, Ww, Ss, Ss, Ss^Vhs, Ww, Ss, Ss, Ss, Ss, Ww, Ss, Ss, Ss, Ww, Ww, Ww, Ss, Ss, Gg, Re, Ss, Ss, Gs^Fp, Ss, Ss, Ss, Ss, Ss, Ss, Ss, Gs^Fp, Gs^Fp, Gs^Fp, Ss, Ss, Ss
Re, Ss, Ss, Ww, Ss, Ss, Ww, Ss, Ww, Ww, Ss, Ss, Ss, Ss, Ss, Ss, Ss, Ss, Ss, Ss, Ss, Ss, Gs^Fp, Ss, Gg, Re, Ss^Vhs, Ss, Ss, Ss, Ss, Ss, Ss, Ss, Ss, Ss, Ss, Gs^Fp, Gs^Fp, Gs^Fp, Ss, Gg
Ww, Ch, Ss, Ww, Ss, Ss, Ss, Ww, Ss^Vhs, Ss, Gg, Gg, Gg, Gg, Ss, Ss, Ss, Ss, Ss, Ss, Ss, Ss, Ss, Ss, Gg, Re, Ss, Ss, Ss, Ss, Ss, Ss, Ss, Ss, Ss, Ss, Ss, Ss, Gs^Fp, Gs^Fp, Ss, Gg
Re, Ch, Ww, Ww, Ss, Ss, Ss, Ss, Gg, Gg, Gg, Hh, Gg, Gg, Gg, Ss, Ss, Ss, Ss, Ss, Ss, Ss, Ss, Ss, Ss, Re, Re, Gg, Ss, Ss, Gs^Fp, Gs^Fp, Ss, Ss, Ss, Ss, Ss, Ss, Ss, Ss, Ss, Gg
Re, Gg, Ss, Ss, Ss, Ss, Ss, Ss, Gg, Ss, Ss, Ss, Gg, Gg, Gg, Ss, Ss, Ss, Hh, Ss, Ss, Ss, Ss, Ss, Ss, Gg, Re, Gg, Ss, Ss, Ss, Ss, Ss, Ss, Hh, Hh, Ss, Ss, Ss, Ss, Ss, Gg
Hh, Re, Ss, Ss, Ss, Ss, Ss, Ss, Ss, Ss, Ss, Ss, Gg, Gg, Gg, Hh, Hh, Hh, Ss, Ss, Ss, Ss, Ss, Ss, Ss, Ss, Gg, Re, Ss, Ss, Ss, Ss, Ss^Vhs, Hh, Hh, Mm, Mm, Ss, Ss^Vhs, Ss, Ss, Hh
Hh, Re, Ss^Vhs, Ss, Ss, Ss, Ss, Ss, Ss, Ss, Ss, Ss, Gg, Gg, Ss, Gg, Hh, Hh, Ss, Ss, Ss^Vhs, Ss, Ss, Ss, Ss, Ss, Ss^Vhs, Re, Gg, Gg, Gg, Gg, Hh, Hh, Mm, Mm, Mm, Hh, Hh, Hh, Hh, Hh
Hh, Re, Ch, Ss, Ss, Ss, Ss, Ss, Ss, Ss, Ss, Ss, Ss^Vhs, Ss, Ss, Ss, Ss, Ss, Ss, Ss, Ss, Ss, Ss, Ss, Ss, Ss, Ss, Re, Gg, Gg, Gg, Gg, Mm, Mm, Mm, Mm, Mm, Mm, Hh, Hh, Hh, Hh
Hh, Ss, Ww^Bw|, Ss, Ss, Ss, Ss, Gs^Fp, Ss, Ss, Ss, Ss, Ss, Ss, Ss, Ss, Ss, Ss, Ss, Ss, Ss, Ss, Ss, Ss, Ss, Ss, Ss, Re, Gg, Gg, Gg, Gg, Hh, Mm, Mm, Mm, Mm, Mm, Hh, Hh, Hh, Hh
Hh, Ss, Ww^Bw|, Gs^Fp, Ss, Ss, Ss, Ss, Ss, Ss, Gg, Ss, Ss, Ss, Ss, Ss, Gs^Fp, Ss, Ss, Ss, Ss, Ss, Ss, Ss, Ss, Ss, Ww^Bw/, Re, Gg, Gg, Gg, Ss, Hh, Mm, Mm, Mm, Mm, Hh, Ss, Hh, Hh, Hh
Ss, Ss, Ww^Bw|, Ss, Gs^Fp, Gs^Fp, Ss, Ss, Ss, Ss, Gg, Ss, Ss, Ss, Ss, Gs^Fp, Gs^Fp, Gs^Fp, Ss, Ss, Ss, Gs^Fp, Ss, Ss, Ww^Bw/, Ww^Bw/, Ss, Gg, Gg, Gg, Ss, Ss, Ss^Vhs, Hh, Mm, Mm, Mm, Hh, Ss, Ss, Hh, Ss
Ss, Ss, Ww^Bw|, Ss, Gs^Fp, Gs^Fp, Ss, Ss, Ss, Ss, Gg, Ss, Ss, Ss, Gs^Fp, Gg^Ve, Gs^Fp, Gs^Fp, Ss, Ss, Gg, Ss, Ww^Bw/, Ww^Bw/, Ss, Ss, Ss, Ss, Ss, Ss, Ss, Ss, Ss, Hh, Hh, Mm, Hh, Ss, Ss, Ss, Ss, Ss
Ss, Ss, Ch, Ss, Ss, Ss, Ss, Ss, Ww, Ww, Ss^Vhs, Ss, Ss, Ss, Gs^Fp, Gs^Fp, Gs^Fp, Ss, Ss, Ww, Re, Re, Ss, Ss, Ss, Ss, Ss, Ss, Ss, Ss, Ss, Ss, Hh, Hh, Hh, Hh, Gg, Ss, Ss, Ss, Gs^Fp, Gs^Fp
Hh, Ss, Ss, Ch, Ss, Ss, Hh, Ww, Ww, Ww, Ww, Ss, Ss, Ss, Ss, Ss, Ss, Ss, Ww, Ww, Re, Ss, Ss, Gs^Fp, Ss, Ss, Ss, Ss, Ss, Ss, Ss, Hh, Ss, Ss, Hh, Gg, Ss, Ss, Gs^Fp, Gs^Fp, Gs^Fp, Ss
Hh, Ss, Gg, Re, Ww^Bw\, Hh, Mm, Mm, Re, Ww, Ww, Ss, Re, Re, Re, Gg, Ch, Ss, Ww^Bw/, Ww^Bw/, Ww, Ss, Gs^Fp, Gs^Fp, Gs^Fp, Ww, Ww, Ss, Ss, Ss, Hh, Hh, Hh, Gg, Ss, Ss, Ss, Ss, Gs^Fp, Gg^Ve, Gs^Fp, Ss
Ss, Ss, Gg, Gg^Ve, Hh, Re, Re, Re, Hh, Re, Ch, Ww^Bw/, Ww, Ww, Gg, Re, Ss, Ch, Ss, Ww, Ss^Vhs, Ss, Ss, Ss, Ww, Ww, Ww, Ss^Vhs, Ss, Hh, Hh, Mm, Mm, Hh, Hh, Ss, Ss, Ss, Gs^Fp, Gs^Fp, Ww, Gs^Fp
Ss, Ss, Gg, Gg, Gg, Hh, Re, Hh, Hh, Hh, Hh, Ww, Ss, Ww, Ww, Ss, Ss, Ss, Ww, Ww, Gs^Fp, Ss, Ss, Ss, Ww, Gs^Fp, Ss, Ww, Ww, Hh, Mm, Mm, Mm, Mm, Hh, Hh, Ss, Ss, Ss, Ss, Ss, Gs^Fp
Ss, Gg, Gg, Ss, Ss, Ss, Ww^Bw|, Ss, Hh, Hh, Hh, Ss^Vhs, Ss, Ss, Ww, Ss, Ss, Ww, Ss, Ss, Ss, Gg, Gg, Ww, Ss, Ss, Ss, Ss, Ss, Ww, Ww, Mm, Mm, Mm, Hh, Hh, Hh, Ss, Ss, Ss, Ss, Ss
Gg, Gg, Gg, Ss, Ss, Ss, Ww^Bw|, Ss, Ss, Ss, Hh, Hh, Ss, Ss, Ww, Ss^Vhs, Ww, Ww, Ss, Ss, Ss^Vhs, Ww, Ww, Ww, Ss, Ss, Ss, Ss, Ss, Hh, Hh, Ww, Ww, Hh, Ww, Hh, Hh, Ss, Ss, Ss, Ss, Ss
Gg, Gg, Gg, Ss, Gs^Fp, Gs^Fp, Re, Ss, Ss, Ss, Hh, Hh, Hh, Hh, Hh, Ww, Ww, Ww, Hh, Ww, Ww, Ww, Ss, Ss, Ss, Ss, Ss, Ss, Ss, Ss, Ss, Ss, Ww, Ww, Ww, Hh, Hh, Ss, Hh, Ss, Ss, Ss
Gg, Gg, Ss, Ss, Gs^Fp, Gs^Fp, Re, Ss, Ss, Ss, Ss, Hh, Hh, Mm, Mm, Mm, Mm, Mm, Ww, Ww, Mm, Ww, Ss, Ss, Ss, Ss, Ss, Ss, Ss, Ss, Ss, Ss, Ss, Ss^Vhs, Ww, Hh, Hh, Hh, Ss, Ss, Ss, Ss
Ss, Ss, Ss, Ss, Ss^Vhs, Re, Gs^Fp, Gs^Fp, Ss, Ss, Ss, Ss, Hh, Mm, Mm, Mm, Mm, Ww, Ww, Mm, Mm, Hh, Ss, Ss, Ss^Vhs, Ss, Ss, Ss, Ss, Ss, Ss, Ss, Ss, Hh, Hh, Ww, Hh, Hh, Ss^Vhs, Ss, Ww, Ss
Ss, Ss, Ss, Ss, Ss, Ww^Bw|, Gs^Fp, Gs^Fp, Gs^Fp, Gs^Fp, Ss, Ss, Ss, Hh, Mm, Mm, Mm, Ww, Ww, Mm, Mm, Hh, Ss, Ss, Ss, Ss, Ss, Ss, Hh, Ss, Ss, Ss, Hh, Hh, Hh, Ww, Hh, Hh, Ww, Ww, Ww, Ww
Ss, Ss, Ss, Ch, Ch, Ch, Ss, Ss, Ss, Ss, Ss, Ss, Ss, Ss, Hh, Mm, Mm, Ww, Mm, Mm, Mm, Hh, Gs^Fp, Ss, Ss, Ss, Ss, Hh, Mm, Hh, Ss, Hh, Hh, Hh, Ss^Vhs, Ww, Ww, Ww, Ss, Ww, Ss, Ww
Gg, Gg, Gg, Ch, 1 Kh, Ch, Ww^Bw\, Ss, Ss, Ss, Ss, Ss, Ss, Ss, Hh, Mm, Mm, Ww, Mm, Mm, Hh, Gs^Fp, Gs^Fp, Gs^Fp, Ss, Ss, Hh, Hh, Mm, Mm, Hh, Hh, Hh, Ss, Ss, Ww, Ss, Ss, Ss, Ss, Ss, Ss
Gg, Gg, Ch, Ch, Ch, Ss, Ss, Re, Ss, Ss, Ss, Ss, Ss, Ss, Hh, Mm, Mm, Ww, Ww, Hh, Hh, Gs^Fp, Gs^Fp, Ss, Ss, Ss, Ss, Hh, Hh, Mm, Hh, Hh, Ss, Ss, Ss, Ss, Ss, Ss, Ss, Ss, Hh, Ss
Ss, Gg, Gg, Gg, Ss, Ss, Ss, Re, Re, Ss, Ss, Ss, Ww, Ww, Ss, Hh, Ww, Ww, Ww, Hh, Gs^Fp, Ss, Gs^Fp, Gs^Fp, Ss, Ss, Gg^Ve, Ss, Ss, Hh, Hh, Ss, Ss, Ss, Gs^Fp, Gs^Fp, Ss, Ss, Ss^Vhs, Hh, Hh, Ss
Ss, Hh, Gg, Hh, Ss, Ss, Ss, Ss, Re, Ss, Ss, Ss, Ww, Ww, Ss^Vhs, Ww, Hh, Ww, Ww, Ww, Ww, Gs^Fp, Gs^Fp, Ss, Ss, Ww, Ww, Ss, Ss, Ss, Ss, Ss, Hh, Ss, Ss, Ss, Ss, Ss, Ss, Hh, Hh, Hh
Ss, Gg, Hh, Gg, Gg, Ss, Ss, Ss, Re, Ss, Ss^Vhs, Ww, Ss, Ww, Ww, Ww, Hh, Hh, Ww, Ss^Vhs, Ww, Ww, Ww, Ss, Ww, Ww, Ww, Ww, Ww, Ss, Ss, Ss, Ss, Ss, Gg, Ss, Ss, Ss, Ss, Ss, Hh, Mm
Hh, Hh, Gg, Gg, Ww, Gg, Gg, Ss, Ss, Ss, Ww, Ww, Gg, Ww, Ss, Ww, Hh, Hh, Hh, Ww, Ss, Ww, Ww, Ww, Ss, Ss, Ss, Ss, Ww, Ww, Ss, Ss, Ss, Gg, Gg, Gg, Ss, Ss, Ss, Ss, Ss, Ss
