Gd, Gd, Aa^Fpa, Gd, Aa, Aa, Aa, Aa, Aa, Aa, Re, Re, Gd, Re, Re, Ww, Ww, Ww, Ww, Ww, Ww, Aa^Fpa, Gd, Gd, Aa, Aa, Aa, Aa, Aa, Aa, Aa, Aa, Aa, Aa, Aa, Aa, Ha, Ww, Ww, Ww, Hhd, Aa^Fpa
Aa^Fpa, Aa^Fpa, Ww, Gd^Vh, Gd, Aa, Aa, Gd, Re, Re, Aa^Fpa, Aa^Fpa, Aa^Fpa, Aa^Vha, Ww, Ww, Ww, Ww, Wo, Ww, Ww, Gd, Aa, Aa, Aa, Gd, Gd, Gd, Gd, Gd, Gd, Gd, Gd, Gd, Aa, Aa, Ww, Ww, Ww, Hhd, Hhd, Aa^Fpa
Aa^Fpa, Aa^Fpa, Ww, Ww, Gd, Gd, Gd, Re, Gd, Aa^Vha, Gll^Fp, Gll^Fp, Gll^Fp, Aa^Fpa, Gd, Ai, Ww, Ww, Wo, Wo, Ww, Ai, Aa, Aa, Aa, Gd, Aa^Fpa, Aa^Fpa, Aa^Fpa, Aa^Fpa, Aa^Fpa, Gd, Gd, Gd, Gd, Gd, Gd, Ww, Ww, Hhd, Hhd, Gll^Fp
Gd, Gd, Aa^Fpa, Aa^Fpa, Ch, Ch, Ch, Re, Aa^Fpa, Aa^Fpa, Gll^Fp, Gd, Gll^Fp, Aa^Fpa, Aa, Aa, Ai, Ww, Ww, Ww, Ai, Aa, Aa, Aa, Gd, Gd, Aa^Fpa, Gll^Fp, Aa^Fpa, Aa^Fpa, Aa^Fpa, Gd, Gd, Gd, Gd, Aa^Fpa, Aa^Fpa, Aa^Fpa, Aa^Fpa, Aa^Fpa, Aa^Fpa, Aa^Fpa
Aa, Gd, Aa^Fpa, Aa^Fpa, Ch, 1 Kh, Ch, Gll^Fp, Aa^Fpa, Gd, Aa^Fpa, Gll^Fp, Aa^Fpa, Gd, Aa, Ai, Ai, Ai, Ai, Ai, Aa, Aa, Aa, Aa, Aa, Gd, Aa^Fpa, Gll^Fp, Gll^Fp, Aa^Fpa, Gd, Aa, Ai, Ai, Gd^Vh, Gd, Aa^Fpa, Aa^Fpa, Aa^Fpa, Gd, Aa^Fpa, Aa^Fpa
Aa, Gd, Aa^Fpa, Ch, Ch, Ch, Gll^Fp, Aa^Fpa, Aa^Fpa, Aa^Fpa, Aa^Fpa, Aa^Fpa, Aa^Fpa, Gd, Aa, Ai, Ai, Ww, Gd, Gd, Gd, Aa, Aa, Aa, Aa, Gd, Aa^Fpa, Aa^Fpa, Aa^Fpa, Aa^Fpa, Gd, Aa, Ai, Ww, Aa, Gd, Gd, Aa^Fpa, Aa^Fpa, Gd, Gd, Aa^Fpa
Aa, Gd, Aa^Fpa, Aa^Fpa, Re, Gll^Fp, Aa^Fpa, Aa^Fpa, Aa^Vha, Aa^Fpa, Gd, Aa, Aa, Gd, Ai, Ww, Ww, Ww, Aa^Fpa, Aa^Fpa, Gd, Aa, Aa, Aa, Aa, Gd, Aa^Fpa, Aa^Vha, Aa^Fpa, Aa^Fpa, Gd, Aa, Aa, Aa, Aa, Aa, Gd, Aa^Fpa, Aa^Fpa, Gd, Gd, Aa^Fpa
Ha, Hhd, Hhd, Hhd, Aa^Fpa, Re, Aa^Fpa, Aa^Fpa, Aa^Fpa, Gd, Gd, Aa, Aa, Aa, Ww, Ww, Ww, Aa^Vha, Aa^Fpa, Gd, Gd, Aa, Aa, Aa, Aa, Gd, Gd, Aa^Fpa, Gd, Gd, Aa, Aa, Aa, Aa, Aa, Gd, Gd, Aa^Fpa, Aa^Vha, Aa^Fpa, Aa^Fpa, Gd
Hhd, Mm, Hhd, Hhd, Aa^Vha, Re, Gd, Gd, Aa^Fpa, Aa^Fpa, Gd, Gd, Aa, Aa, Gd, Ww, Aa^Fpa, Aa^Fpa, Gd, Gd, Gd, Gd, Aa, Gd, Aa^Vha, Aa^Fpa, Aa^Fpa, Aa^Fpa, Aa^Fpa, Gd, Gd, Aa, Aa, Aa, Aa, Gd, Gd, Aa^Fpa, Aa^Fpa, Aa^Fpa, Aa^Fpa, Gd
Mm, Mm, Re, Ww, Re, Re, Aa, Gd, Gd, Aa^Fpa, Aa^Fpa, Gd, Gd, Aa, Ai, Ww, Gd, Aa^Fpa, Gd, Gd, Gd, Gd, Gd, Aa^Fpa, Gll^Fp, Ww, Ww, Gd, Gd, Gll^Fp, Aa^Fpa, Gd, Aa, Aa, Aa, Gd, Aa^Fpa, Aa^Fpa, Aa^Fpa, Aa^Fpa, Aa^Fpa, Aa^Fpa
Re, Ww^Bw/, Ww, Ww, Ai, Re, Aa, Aa, Gd, Gd, Aa^Fpa, Aa^Fpa, Gd, Aa, Ai, Aa, Aa, Gd, Gd, Gd, Gd, Gd, Aa^Fpa, Aa^Fpa, Gd, Gd^Vh, Gd, Gd, Gd, Ww, Gll^Fp, Aa^Fpa, Aa, Aa, Aa, Gd, Aa^Fpa, Aa^Fpa, Aa^Fpa, Aa^Fpa, Aa^Fpa, Aa^Fpa
Mm, Mm, Ww, Ww, Ww, Re, Re, Gd, Gd, Gd, Gd, Gd, Gd, Aa, Ai, Aa, Aa, Aa, Gd, Gd, Gd, Gd, Aa^Fpa, Gll^Fp, Gd, Gd, Gd, Gd, Gd, Gd, Gd, Aa^Fpa, Gd, Aa, Ha, Hhd, Gd, Aa^Fpa, Aa^Fpa, Aa^Fpa, Aa^Fpa, Gd
Hhd, Hhd, Ww, Ww, Ww, Ww, Ww, Re, Aa, Aa, Aa, Aa, Aa, Aa, Ai, Aa, Aa, Aa, Gd, Gd, Aa^Fpa, Aa^Fpa, Aa^Fpa, Gll^Fp, Gd, Gd, Gd, Gd, Gd, Gd, Gd, Gll^Fp, Aa^Fpa, Gd, Ha, Hhd, Gd, Gd, Gd, Gd, Gd, Gd
Hhd, Ww, Ww, Ww, Ww, Ww, Ww, Re, Re, Ha, Hhd, Gd, Aa^Fpa, Gd, Ww, Aa, Gd, Aa, Aa, Aa, Gd, Aa^Fpa, Aa^Fpa, Aa^Fpa, Gd, Gd, Gd, Gd, Gd, Gd, Gd, Gd, Aa^Fpa, Gd, Hhd, Hhd, Gd, Gd^Vh, Gd, Gd, Aa, Aa
Gll^Fp, Hhd, Ww, Ww, Ww, Ww, Gll^Fp, Aa^Fpa, Gd, Re, Re, Re, Re, Ww, Aa^Vha, Aa^Fpa, Gd, Gd, Aa, Aa, Aa, Aa^Fpa, Aa^Vha, Aa^Fpa, Gll^Fp, Gll^Fp, Aa^Fpa, Gll^Fp, Gd, Gd, Gd, Gd, Gll^Fp, Aa^Fpa, Aa^Fpa, Gd, Gd, Gd, Gd, Gd, Aa, Aa
Gll^Fp, Gll^Fp, Gd, Ww, Gd^Vh, Ww, Ww, Aa^Fpa, Aa^Fpa, Aa^Fpa, Gd^Vh, Gd, Re, Ww, Gll^Fp, Aa^Fpa, Aa^Fpa, Gd, Aa, Aa, Aa, Gd, Aa^Fpa, Aa^Fpa, Aa^Fpa, Aa^Fpa, Aa^Fpa, Aa^Fpa, Gll^Fp, Gll^Fp, Gll^Fp, Aa^Fpa, Aa^Fpa, Aa^Fpa, Gd, Gd, Aa, Aa, Aa, Aa, Aa, Aa
Aa^Fpa, Gll^Fp, Gd, Gd, Gd, Ww, Gll^Fp, Ww, Ww, Ww, Ww, Ww, Ww, Ww, Gll^Fp, Aa^Fpa, Gd, Aa, Aa, Aa, Aa, Gd, Aa^Fpa, Aa^Fpa, Aa^Fpa, Aa^Fpa, Aa^Fpa, Aa^Fpa, Aa^Fpa, Aa^Fpa, Aa^Fpa, Aa^Vha, Aa^Fpa, Gd, Gd, Gd, Aa, Aa, Aa, Aa, Aa, Aa
Aa^Fpa, Gll^Fp, Gd, Gd, Gd, Gd, Aa^Fpa, Gd, Ww, Ww, Gd, Gd, Gd, Re, Re, Gd, Aa, Aa, Aa, Aa, Aa, Aa, Gd, Aa^Fpa, Aa^Fpa, Aa^Vha, Aa^Fpa, Gd, Aa^Fpa, Aa^Fpa, Gd, Aa^Fpa, Aa^Fpa, Gd, Gd, Gd, Aa, Aa, Aa, Aa, Aa, Aa
Aa^Fpa, Gll^Fp, Gd, Gd, Gd, Gll^Fp, Aa^Fpa, Gd, Gd, Aa^Fpa, Gll^Fp, Gd, Gd, Gd, Gll^Fp, Re, Aa, Aa, Aa, Aa, Aa, Aa, Gd, Gd, Aa^Fpa, Aa^Fpa, Aa^Fpa, Gd, Gd, Gd, Gd, Hhd, Hhd, Hhd, Hhd, Hhd, Gd, Aa, Aa^Vha, Aa, Aa, Aa
Gd, Aa^Fpa, Gll^Fp, Gll^Fp, Gll^Fp, Aa^Fpa, Gd, Aa, Aa, Gd, Aa^Fpa, Aa^Fpa, Gll^Fp, Aa^Fpa, Aa^Fpa, Re, Aa, Aa, Aa, Aa, Aa, Aa, Aa, Aa, Gd, Gd, Aa, Aa, Gd, Ha, Ha^Vhha, Mm, Mm, Mm, Mm, Hhd, Hhd, Gd, Aa, Aa, Aa, Aa
Gd, Gd, Aa^Fpa, Gll^Fp, Gll^Fp, Aa^Fpa, Gd, Aa, Aa, Aa, Gd, Gd, Gd, Gd, Gd, Re, Re, Aa, Aa, Aa, Aa, Aa, Gd, Aa, Aa, Aa, Aa, Aa, Ha, Ms, Mm, Mm, Mm, Mm, Mm, Mm, Hhd, Ha, Aa, Aa, Aa, Aa
Gd, Gd, Aa^Fpa, Gll^Fp, Gll^Fp, Aa^Fpa, Aa, Aa, Aa, Gd, Aa^Fpa, Aa^Fpa, Aa^Fpa, Aa^Vha, Gd, Gd, Aa, Re, Aa, Aa, Aa, Aa, Aa, Aa, Aa, Aa, Aa, Ha, Mm, Mm, Mm, Mm, Mm, Mm, Mm, Mm, Hhd, Gd, Aa, Aa, Aa, Gd
Gd, Gd, Aa^Fpa, Gll^Fp, Aa^Fpa, Gd, Aa, Aa, Aa, Aa^Fpa, Aa^Fpa, Aa^Vha, Aa^Fpa, Aa^Fpa, Aa^Fpa, Aa^Fpa, Aa^Fpa, Re, Re, Aa, Gd, Gd, Gd, Gd, Gd, Gd, Gd, Hhd, Mm, Mm, Mm, Mm, Mm, Mm, Mm, Ha, Ha, Aa, Aa, Aa, Aa, Gd
Gd, Gd, Aa^Vha, Aa^Fpa, Aa^Fpa, Gd, Aa, Aa, Aa, Aa, Gd, Gd, Gd, Aa^Fpa, Aa^Fpa, Gll^Fp, Aa^Fpa, Aa^Fpa, Re, Gd, Gd, Aa^Vha, Gd, Gd, Gd, Aa^Fpa, Hhd, Mm, Mm, Mm, Mm, Mm, Mm, Hhd, Ha, Ha, Ha, Aa, Aa, Aa, Aa, Gd
Aa^Fpa, Aa^Fpa, Aa^Fpa, Gd, Gd, Gd, Aa, Aa, Aa, Gd, Gd, Gd, Gd, Aa^Fpa, Aa^Fpa, Aa^Fpa, Aa^Fpa, Aa^Fpa, Re, Ww, Aa^Fpa, Aa^Fpa, Gd, Gd, Gd, Aa^Fpa, Hhd, Mm, Mm, Mm, Mm, Mm, Hhd, Aa^Fpa, Gd, Aa, Aa, Aa, Aa, Aa, Ha, Ha
Aa^Fpa, Hhd, Ha, Gd, Gd, Gd, Aa, Aa, Gd, Gd, Gd, Gd, Aa^Fpa, Aa^Fpa, Aa^Fpa, Aa^Fpa, Aa^Fpa, Aa^Fpa, Re, Aa^Fpa, Aa^Vha, Gd, Aa, Gd, Gd, Hhd, Hhd, Mm, Hhd, Hhd, Hhd, Aa^Fpa, Aa^Fpa, Gd, Gd, Aa, Aa, Aa, Aa, Aa, Re, Re
Hhd, Hhd, Hhd, Hhd, Aa^Fpa, Aa^Fpa, Aa^Fpa, Aa^Fpa, Gd, Gd, Gd, Gd, Aa^Fpa, Aa^Fpa, Aa^Fpa, Gd, Gd, Gd, Gd, Re, Gd, Gd, Aa, Aa, Gd, Hhd, Hhd, Hhd, Hhd, Hhd, Aa^Fpa, Aa^Fpa, Aa^Fpa, Gd, Aa, Aa, Aa, Aa, Re, Re, Aa, Aa
Ww, Ww, Ww, Hhd, Aa^Fpa, Aa^Fpa, Gll^Fp, Aa^Fpa, Aa^Fpa, Aa^Fpa, Gd, Aa^Fpa, Aa^Fpa, Aa^Fpa, Gd, Aa, Aa, Aa, Aa, Re, Re, Aa, Aa, Aa, Gd, Hhd, Hhd, Hhd, Aa^Fpa, Aa^Vha, Aa^Fpa, Gd, Gd, Gd, Re, Re, Re, Re, Aa, Aa, Aa^Vha, Aa
Ww, Ww, Ww, Ww, Gll^Fp, Aa^Fpa, Aa^Fpa, Aa^Fpa, Aa^Fpa, Aa^Fpa, Aa^Fpa, Gd, Aa^Fpa, Gd, Gd, Aa, Aa, Aa, Aa, Aa, Re, Aa, Aa, Aa, Aa, Gd, Gd, Gd, Gd, Gd, Aa^Vha, Gd, Re, Re, Aa, Aa, Aa, Aa, Aa, Aa, Aa, Aa
Ww, Ww, Ww, Ww, Gd, Gll^Fp, Aa^Fpa, Aa^Vha, Gll^Fp, Gll^Fp, Aa^Fpa, Gd, Gd, Gd, Aa, Aa, Aa, Aa, Aa, Aa, Aa, Re, Aa, Aa, Aa, Gd, Aa^Fpa, Gd, Gd, Gd, Re, Re, Ww, Ww, Ai, Aa, Ai, Aa, Ai, Ai, Aa, Aa
Ww, Ww, Ww, Hhd, Hhd, Gd, Gd, Gll^Fp, Gd, Aa^Fpa, Aa^Fpa, Aa, Aa, Aa^Vha, Aa, Aa, Ai, Ai, Ha, Ha, Aa, Re, Aa, Aa, Aa, Gd, Aa^Fpa, Aa^Fpa, Re, Re, Aa^Fpa, Ww, Ww, Ww, Ai, Ai, Aa, Ai, Ai, Ai, Aa, Aa
Ww, Ww, Ww, Mm, Ww, Gd, Gd, Gd, Gll^Fp, Aa^Fpa, Gd, Aa, Aa, Aa, Aa, Aa, Ai, Ai, Ms, Ha, Ha, Re, Re, Aa, Aa, Gd, Re, Re, Aa^Vha, Aa^Fpa, Hhd, Ww, Ww, Ww, Ww, Ai, Aa, Aa, Aa, Ai, Aa, Aa
Ww, Hhd, Ww, Hhd, Ww, Gd^Vh, Gd, Gd, Gd, Aa^Fpa, Gd, Aa, Aa, Aa, Ai, Ai, Ai, Ai, Ai, Ai, Ha, Aa, Re, Aa, Aa, Gd, Re, Aa^Fpa, Aa^Fpa, Aa^Fpa, Hhd, Ww, Ww, Ww, Ww, Aa, Gd, Aa, Aa, Ai, Aa, Aa
Ww, Ww, Ww, Ww, Ww, Gd, Gd, Gd, Gll^Fp, Aa^Fpa, Aa, Aa, Ai, Ai, Ai, Ai, Ai, Ai, Ai, Ai, Ha, Aa, Aa^Vha, Re, Re, Gd, Re, Aa^Fpa, Aa^Fpa, Aa^Fpa, Gd, Aa, Ai, Ai, Ai, Ww, Gd, Gd, Aa, Ai, Ai, Aa
Ww, Ww, Ww, Ww, Ww, Ww, Ww, Gll^Fp, Aa^Fpa, Gd, Aa, Aa, Ai, Ai, Ai, Ai, Ai, Ai, Ai, Ai, Ha, Aa, Aa, Aa, Aa, Re, Gd, Aa^Fpa, Aa^Fpa, Gd, Aa, Aa, Ai, Ai, Ai, Gd, Gd, Gd, Gd, Aa, Aa, Ai
Ww, Ww, Ww, Ww, Ww, Aa^Fpa, Ww, Ww, Aa^Fpa, Gd, Aa, Aa, Aa, Aa, Ai, Ai, Ai, Ai, Ms, Ha, Ha, Aa, Aa, Aa, Aa, Re, Ch, Ch, Ch, Aa, Aa, Aa, Aa, Aa, Aa, Aa, Gd, Gd, Gd, Aa, Ai, Ai
Gd, Ww, Ww, Aa^Fpa, Aa^Fpa, Gd, Gd^Vh, Ww, Gd^Vh, Aa, Aa, Aa, Aa^Vha, Aa, Ai, Aa, Ai, Ai, Ha, Ha, Aa, Aa, Aa, Aa, Gd, Ww, Ch, 2 Kh, Ch, Gd, Gd, Aa, Aa, Gd, Gd, Gd, Gd, Gd, Gd^Vh, Aa, Ai, Ai
Gd, Ww, Gll^Fp, Aa^Fpa, Gd, Aa, Ww, Ww, Ai, Gd, Aa, Aa, Aa, Aa, Aa, Aa, Aa, Ai, Aa, Aa, Aa, Aa, Aa, Gd, Gd, Ch, Ch, Ch, Aa^Fpa, Re, Aa^Fpa, Aa^Fpa, Aa^Fpa, Aa^Fpa, Aa^Vha, Aa^Fpa, Gd, Ww, Ww, Ai, Ai, Ai
Gd, Ww, Aa^Fpa, Aa^Fpa, Ai, Ww, Ww, Ww, Ai, Gd, Gd, Gd, Aa, Gd, Gd, Gd, Aa, Ww, Aa, Aa, Gd, Gd, Gd, Gd, Aa^Fpa, Aa^Fpa, Aa^Fpa, Aa^Fpa, Gd, Re, Aa^Fpa, Gll^Fp, Aa^Fpa, Aa^Fpa, Aa^Fpa, Aa^Fpa, Aa^Fpa, Ww, Ai, Ai, Aa, Ai
Ww, Ww, Ww, Ww, Ww, Ai, Ai, Ai, Ww, Aa^Fpa, Aa^Fpa, Aa^Fpa, Gd, Aa^Fpa, Aa^Fpa, Aa^Fpa, Aa^Fpa, Ww, Aa, Gd, Gd, Aa^Fpa, Aa^Fpa, Gd, Aa^Fpa, Aa^Vha, Aa^Fpa, Gd, Gd, Re, Aa^Fpa, Gll^Fp, Gll^Fp, Aa^Fpa, Aa^Fpa, Aa^Fpa, Ww, Ww, Ww, Ai, Ai, Ai
Ww, Ww, Ai, Ai, Ai, Ww, Ww, Aa, Ww, Ww, Gll^Fp, Gll^Fp, Gd, Aa^Fpa, Aa^Fpa, Aa^Fpa, Ww, Ww, Gd, Gd, Aa^Fpa, Aa^Fpa, Aa^Fpa, Gd, Gd, Gd, Gd, Aa, Aa, Re, Re, Re, Re, Gll^Fp, Aa^Fpa, Aa^Fpa, Ww, Ww, Ww, Ww, Aa, Ww
Ww, Ww, Ai, Ai, Ww, Ww, Gd, Gd, Aa^Fpa, Ww, Ww, Ww, Ww, Gd, Ww, Ww, Aa^Fpa, Gd, Gd, Aa^Fpa, Aa^Fpa, Gd, Gd, Gd, Aa, Aa, Aa, Gd, Gd, Re, Re, Aa^Fpa, Re, Re, Re, Re, Ww, Ww, Gd, Aa^Fpa, Aa^Fpa, Gd
