Aa, Ai, Aa, Aa, Ha, Ms, Ms, Mm, Mm, Mm, Mm, Ww, Ai, Ai, Ai, Ww, Ww, Aa^Fpa, Gll^Fp, Aa^Fpa, Gd, Re, Re, Gll^Fp, Gd, Gd, Re, Gd, Gd, Gll^Fp, Aa^Fpa, Aa, Gd, Aa^Fpa, Gll^Fp, Gll^Fp, Gd, Gd, Gd, Gd, Gd, Aa^Fpa
Re, Re, Re, Gd, Aa, Ms, Mm, Mm, Mm, Mm, Mm, Hhd, Ai, Ai, Ww, Ww, Gd, Aa^Fpa, Gll^Fp, Gll^Fp, Aa^Fpa, Gd, Gd, Re, Re, Re, Gd^Vh, Re, Gd, Aa^Fpa, Gd, Aa, Gd, Gll^Fp, Gd^Vh, Gd, Gd, Gd, Gd, Gd, Gll^Fp, Aa^Fpa
Ww, Ai, Aa^Vha, Re, Hhd, Mm, Mm, Mm, Mm, Mm, Hhd, Aa^Fpa, Gd, Ai, Gd, Ai, Ai, Gd, Aa^Fpa, Aa^Fpa, Gll^Fp, Aa^Fpa, Aa^Vha, Gll^Fp, Gd, Gd, Gd, Re, Re, Gd, Aa, Aa, Aa^Fpa, Gll^Fp, Gd, Gd, Gd, Gd, Gd, Aa^Fpa, Gd, Gd
Ww, Gd, Aa, Re, Mm, Mm, Mm, Mm, Mm, Hhd, Aa^Fpa, Aa^Fpa, Gd, Ww, Aa, Ai, Aa, Ww, Ww, Gll^Fp, Gll^Fp, Gll^Fp, Aa^Fpa, Aa^Fpa, Gd, Gd, Gd, Gd, Gll^Fp, Re, Re, Gd, Ch, Ch, Ch, Gd, Gd^Vh, Gd, Aa^Fpa, Gd, Aa, Aa
Aa^Fpa, Aa^Fpa, Gd, Re, Re, Mm, Mm, Mm, Ha, Gd, Gd, Aa^Vha, Aa^Fpa, Gd, Gd, Ww, Aa, Ww, Aa^Fpa, Gll^Fp, Gll^Fp, Gll^Fp, Gll^Fp, Gll^Fp, Gll^Fp, Gd, Gd, Gll^Fp, Aa^Fpa, Gd, Aa, Re, Ch, 1 Kh, Ch, Re, Re, Gll^Fp, Aa^Fpa, Aa, Aa, Aa
Aa^Fpa, Aa^Fpa, Aa^Fpa, Aa^Fpa, Hhd, Re, Re, Hhd, Gd, Gd, Gd, Aa^Fpa, Aa^Fpa, Gd, Gd, Gd, Aa, Ww, Aa^Fpa, Aa^Fpa, Aa^Fpa, Aa^Fpa, Gll^Fp, Gll^Fp, Gll^Fp, Gll^Fp, Gll^Fp, Gll^Fp, Aa^Fpa, Gd, Gd, Ch, Ch, Ch, Gll^Fp, Gll^Fp, Aa^Fpa, Re, Re, Aa, Re, Aa
Aa^Fpa, Aa^Fpa, Aa^Fpa, Aa^Fpa, Hhd^Vhh, Hhd, Hhd, Re, Re, Gd, Gd, Aa^Fpa, Aa^Fpa, Aa^Fpa, Gd^Vh, Gd, Ww, Ww, Gd, Gd, Gd, Gd, Aa^Fpa, Gll^Fp, Gd, Gll^Fp, Gll^Fp, Gll^Fp, Re, Gd, Gd^Vh, Re, Aa^Fpa, Aa^Fpa, Aa^Fpa, Gll^Fp, Gll^Fp, Aa^Fpa, Gd, Re, Aa, Re
Aa^Fpa, Hhd, Hhd, Hhd, Mm, Mm, Mm, Ha, Re, Aa, Gd, Aa^Fpa, Ww, Ww, Ww, Ww, Ww, Ww, Aa^Fpa, Gd, Gd, Gd, Gd, Aa^Fpa, Gd, Gd, Re, Re, Gll^Fp, Re, Re, Re, Aa^Fpa, Gll^Fp, Gll^Fp, Gll^Fp, Gll^Fp, Gll^Fp, Aa^Fpa, Gd, Gd, Re
Hhd, Mm, Mm, Mm, Mm, Mm, Ms, Ha, Ha, Re, Re, Aa^Fpa, Ww, Ww, Aa^Fpa, Gll^Fp, Aa^Fpa, Aa^Fpa, Aa^Fpa, Aa^Fpa, Gd, Gd, Gd, Aa^Fpa, Gll^Fp, Gd^Vh, Re, Gd, Gll^Fp, Aa^Fpa, Gd, Gd, Aa^Fpa, Gll^Fp, Gd, Gd, Gll^Fp, Aa^Fpa, Aa^Fpa, Gd, Gd, Re
Hhd, Mm, Mm, Mm, Mm, Ms, Ms, Ms, Ha, Aa, Re, Gd, Aa^Fpa, Gd, Aa^Fpa, Aa^Fpa, Gll^Fp, Gll^Fp, Gll^Fp, Aa^Fpa, Aa^Fpa, Aa^Fpa, Re, Re, Re, Re, Gd, Gll^Fp, Hhd, Hhd, Gd, Gd, Aa^Fpa, Gll^Fp, Gd, Gd, Gll^Fp, Aa^Fpa, Gd, Gd, Gd, Re
Mm, Mm, Mm, Mm, Mm, Mm, Ms, Ha, Ha, Gd, Re, Aa^Fpa, Aa^Fpa, Aa^Fpa, Aa^Fpa, Gll^Fp, Gd, Gd, Gll^Fp, Aa^Fpa, Re, Re, Gd, Hhd, Ww, Hhd, Hhd, Hhd, Mm, Ms, Ha, Ha, Aa^Fpa, Gll^Fp, Gll^Fp, Gll^Fp, Aa^Fpa, Gd, Gd, Gd, Gd, Aa
Hhd, Mm, Mm, Mm, Mm, Mm, Mm, Gd, Gd, Aa^Fpa, Aa^Fpa, Re, Re, Aa^Fpa, Gll^Fp, Gd, Gd, Gd, Re, Re, Aa^Vha, Aa^Fpa, Gll^Fp, Ww, Ww, Hhd, Hhd, Mm, Mm, Ms, Ms, Ha, Gd, Aa^Fpa, Aa^Fpa, Gd, Gd, Aa, Aa, Aa, Aa, Aa
Gll^Fp, Hhd, Hhd, Mm, Mm, Hhd, Aa^Fpa, Aa^Fpa, Aa^Fpa, Aa^Vha, Gd, Gd, Re, Gd^Vh, Gll^Fp, Gll^Fp, Re, Re, Gll^Fp, Aa^Fpa, Aa^Fpa, Aa^Fpa, Gll^Fp, Ww, Ww, Mm, Mm, Hhd, Hhd, Ms, Ms, Ha, Aa, Gd^Vh, Gd, Ai, Ai, Aa, Aa, Aa, Aa, Re
Gd, Gd, Hhd, Gll^Fp, Aa^Fpa, Gll^Fp, Aa^Fpa, Gll^Fp, Gll^Fp, Aa^Fpa, Gd, Aa, Gd, Re, Re, Re, Aa^Fpa, Aa^Fpa, Gd, Gd, Aa^Fpa, Aa^Fpa, Ww, Ww, Ww, Ww, Ww, Mm, Ha, Ms, Ms, Ms, Ha, Aa, Aa, Ai, Aa, Aa, Aa, Aa, Aa, Aa
Gd, Hhd, Hhd, Gll^Fp, Gll^Fp, Gd, Gll^Fp, Gll^Fp, Gll^Fp, Aa^Fpa, Gd, Aa, Aa, Aa, Re, Gd, Gd, Gd, Ai, Ai, Aa, Gd, Ww, Ww, Ww, Ww, Ww, Ww, Mm, Ms, Ms, Ms, Ms, Ai, Ai, Ai, Ai, Aa, Aa, Aa, Aa, Aa
Gd, Hhd, Mm, Hhd, Gll^Fp, Gd^Vh, Gll^Fp, Gll^Fp, Aa^Fpa, Aa^Fpa, Aa, Aa, Re, Re, Ai, Ai, Ai, Ai, Ai, Ai, Aa, Aa, Hhd, Hhd, Ww, Ww, Hhd, Ww, Ww, Ha, Ha, Ms, Ms, Ai, Ai, Ai, Ai, Aa, Aa, Aa, Aa, Aa
Mm, Mm, Mm, Hhd, Gll^Fp, Gll^Fp, Aa^Fpa, Gll^Fp, Gll^Fp, Aa^Fpa, Aa, Aa, Re, Aa, Aa, Ai, Ai, Ai, Aa, Ai, Aa, Aa, Aa, Gd, Hhd, Mm, Hhd, Aa^Fpa, Gd^Vh, Ai, Ha, Ms, Ms, Ai, Ai, Ai, Ai, Ai, Ai, Ai, Aa, Aa
Mm, Mm, Hhd, Gll^Fp, Gll^Fp, Gll^Fp, Aa^Fpa, Gll^Fp, Aa^Fpa, Aa^Fpa, Aa, Aa, Re, Aa, Aa, Aa, Aa, Aa, Aa, Ai, Aa, Gd, Aa, Gd, Hhd, Hhd, Aa^Fpa, Aa^Fpa, Ww, Ai, Ha, Ha, Ms, Ms, Ai, Ai, Ai, Ai, Ww, Gd, Gd, Aa
Hhd, Mm, Hhd, Aa^Fpa, Aa^Fpa, Gll^Fp, Gll^Fp, Aa^Fpa, Aa^Fpa, Gd, Aa, Aa, Re, Aa, Aa, Aa, Aa, Aa, Aa, Ai, Aa, Aa, Gd, Aa^Fpa, Aa^Fpa, Aa^Fpa, Aa^Fpa, Ww, Ww, Ww, Hhd, Hhd, Mm, Ms, Ai, Ai, Ai, Aa, Gd, Aa^Fpa, Gd, Gd
Gd, Ha, Hhd, Gd, Gd, Aa^Fpa, Aa^Fpa, Aa^Fpa, Gd, Gd, Aa, Aa, Re, Aa, Aa, Aa, Aa, Aa, Gd, Ww, Gd^Vh, Aa, Ww, Gd, Ww, Ww, Ww, Ww, Gd^Vh, Hhd, Mm, Mm, Mm, Mm, Ww, Ww, Aa, Aa, Gd, Aa^Fpa, Aa^Vha, Gd
Gd, Gd, Gd, Aa^Fpa, Gd, Gd, Gd, Gd, Gd, Aa, Re, Re, Aa^Vha, Aa, Aa, Aa, Aa, Gd, Gd, Ww, Ww, Ai, Aa, Ai, Ai, Ww, Gd, Ww, Ww, Ww, Ww, Mm, Ww, Ww, Ww, Ww, Gd^Vh, Gd, Gd, Gd, Aa^Fpa, Aa^Fpa
Gd, Aa, Gd, Gd, Aa^Fpa, Aa^Fpa, Aa^Fpa, Aa^Fpa, Gd, Gd, Re, Gd, Aa, Aa, Aa, Aa, Gd, Aa^Fpa, Aa^Fpa, Gd, Gd, Gd, Gd, Aa, Aa, Aa, Gd, Gd, Ww, Ww, Ww, Ww, Ww, Ww, Ww, Ww, Ww, Gd, Gd, Gd, Gd, Gd
Gd, Aa, Aa, Aa, Aa, Gd, Gd, Aa^Fpa, Gd, Gd^Vh, Re, Aa, Aa, Aa, Aa, Gd, Aa^Fpa, Gll^Fp, Gll^Fp, Ww, Ww, Gd, Gd, Gd, Gd, Gd, Aa^Fpa, Ww, Ww, Ww, Ww, Ww, Ww, Ww, Ww, Ww, Ww, Ww, Aa, Aa, Aa, Aa
Aa, Aa, Aa, Aa, Aa, Gd, Gd, Gd, Gd, Gd, Aa, Re, Aa, Aa, Aa, Gd, Ww, Ww, Ww, Ww, Ww, Ww, Gd, Gd, Aa^Fpa, Aa^Fpa, Aa^Fpa, Aa^Fpa, Gd, Ww, Ww, Ai, Ai, Ww, Ww, Ww, Ww, Ww, Ai, Aa, Aa, Aa
Gd, Ha, Aa, Aa, Aa, Aa, Aa, Gd, Gd, Aa, Aa, Re, Aa, Aa, Aa, Gd, Ww, Ww, Ww, Ww, Ww, Gd^Vh, Gd, Gd, Gd, Aa^Fpa, Gll^Fp, Ww, Ww, Ww, Ww, Ai, Ai, Ai, Ww, Ww, Ww, Aa^Fpa, Aa, Aa, Aa^Vha, Aa
Aa, Ha, Gd, Aa, Aa, Aa, Aa, Aa, Aa, Aa, Ha, Re, Aa, Aa, Aa, Aa, Ai, Ai, Ww, Ww, Ww, Gd, Gd, Gd, Gd, Aa^Fpa, Gll^Fp, Gll^Fp, Ww, Ww, Ww, Ww, Ai, Ai, Ww, Mm, Mm, Mm, Ha, Gd, Aa, Aa
Ha, Hhd, Gd, Gd, Gd, Gd, Aa, Aa, Ha, Aa, Aa, Re, Re, Aa, Aa, Aa, Aa, Ww, Ww, Ww, Ww, Gd, Gd, Aa, Aa, Gd, Aa^Fpa, Aa^Fpa, Ww, Ww, Ww, Ww, Ai, Ms, Ms, Ms, Mm^Vhh, Mm, Mm, Hhd, Gd, Gd
Gd, Aa^Fpa, Aa^Vha, Hhd, Hhd, Hhd, Ha, Ha, Hhd, Hhd, Hhd, Aa^Vha, Aa^Fpa, Re, Re, Aa, Aa^Fpa, Aa^Fpa, Aa^Fpa, Aa, Aa, Ai, Aa, Aa, Ai, Aa, Ai, Gd^Vh, Ww, Hhd, Ww, Ai, Ai, Ms, Ms, Ms, Ms, Ms, Mm, Hhd, Hhd, Aa^Fpa
Gd, Gd, Aa^Fpa, Hhd, Mm, Mm, Mm, Hhd, Hhd, Hhd, Hhd, Gll^Fp, Gd, Aa, Re, Gd, Aa^Fpa, Aa^Vha, Aa^Fpa, Aa, Aa, Ai, Ai, Ai, Ai, Ai, Ai, Ww, Gd, Ha, Ms, Ms, Ms, Ms, Ms, Ms, Ms, Mm, Mm, Mm, Mm, Hhd
Gd, Gd, Hhd, Mm, Mm, Mm, Mm, Hhd, Gll^Fp, Gd, Hhd, Aa^Fpa, Aa^Fpa, Gd, Re, Gd, Gd, Gd, Gd, Aa, Aa, Ai, Ai, Aa, Aa, Aa, Aa, Aa, Aa, Ha, Ms, Ms, Ms, Ms, Ms, Ms, Mm, Mm, Mm, Mm, Mm, Hhd
Gd, Hhd, Hhd, Mm, Mm, Mm, Mm, Mm, Hhd, Gll^Fp, Hhd, Aa^Fpa, Gd, Re, Gd, Gd, Gd, Gd, Aa, Aa, Aa, Ai, Aa, Aa, Aa, Aa, Gd, Gd, Gd, Gd, Ha, Ha, Ms, Ms, Ms, Ms, Mm, Mm, Mm, Mm, Mm, Hhd
Aa, Ha, Ha, Hhd, Hhd, Mm, Mm, Hhd, Hhd, Gll^Fp, Aa^Fpa, Aa^Fpa, Aa^Fpa, Re, Gd, Gd, Gd, Gd, Aa, Aa, Aa, Ai, Aa, Aa^Vha, Gd, Gd, Gd, Gd, Gd, Gd, Aa, Aa, Aa, Aa, Ha, Ha, Mm, Mm, Mm, Mm, Mm, Hhd
Ha, Ms, Ms, Ch, Ch, Ch, Hhd, Hhd, Hhd, Gll^Fp, Re, Aa^Fpa, Re, Re, Gd, Aa, Aa, Aa, Aa, Aa, Aa, Ai, Aa, Aa, Gd, Aa^Fpa, Aa^Fpa, Aa^Fpa, Aa^Fpa, Aa^Fpa, Gd, Gd, Aa, Aa, Aa, Aa, Hhd, Hhd, Hhd, Mm, Mm, Mm
Ha, Ms, Ha, Ch, 2 Kh, Ch, Hhd, Hhd, Re, Re, Aa^Fpa, Re, Aa^Vha, Gd, Gd, Aa, Aa, Aa, Aa, Aa, Aa, Ai, Ai, Aa, Gd, Aa^Vha, Gll^Fp, Gll^Fp, Gll^Fp, Aa^Fpa, Aa^Fpa, Aa^Fpa, Aa^Fpa, Gd, Gd, Gd, Aa^Fpa, Aa^Vha, Hhd, Mm, Mm, Hhd
Hhd, Ha, Ch, Ch, Ch, Re, Re, Re, Aa^Fpa, Aa^Vha, Aa^Fpa, Gll^Fp, Aa^Fpa, Gd, Aa, Aa, Aa, Aa, Aa, Aa, Aa, Aa, Aa, Ai, Gd, Aa^Fpa, Gd, Gd, Gd, Gll^Fp, Gll^Fp, Ww, Ww, Ww, Aa^Fpa, Aa^Fpa, Aa^Fpa, Aa^Fpa, Aa^Fpa, Hhd, Hhd, Gll^Fp
Aa^Fpa, Gd, Aa, Aa, Aa, Aa^Vha, Aa, Gd, Gll^Fp, Gll^Fp, Gll^Fp, Gll^Fp, Gll^Fp, Aa^Fpa, Aa, Aa, Aa, Aa, Aa, Aa, Aa, Ai, Aa, Ai, Gd, Aa^Fpa, Gll^Fp, Gd, Gd, Gd, Gll^Fp, Ww, Ww, Ww, Aa^Fpa, Aa^Vha, Aa^Fpa, Aa^Fpa, Aa^Fpa, Gll^Fp, Gll^Fp, Aa^Fpa
Aa^Fpa, Gd, Aa, Aa, Aa, Aa, Aa, Aa, Gd, Aa^Fpa, Gll^Fp, Gll^Fp, Gll^Fp, Aa^Fpa, Gd, Ha, Gd, Gd, Gd, Gd, Aa, Aa, Ai, Ai, Gd, Aa^Fpa, Gd, Gd, Gd, Gd, Gll^Fp, Ww, Gll^Fp, Gll^Fp, Gll^Fp, Aa^Fpa, Aa^Fpa, Aa^Fpa, Aa^Fpa, Gll^Fp, Gll^Fp, Aa^Fpa
Gd, Gd, Aa, Gd, Gd, Aa, Aa, Aa, Aa, Hhd, Hhd, Hhd, Hhd, Gd, Ha, Gd, Aa^Fpa, Aa^Fpa, Aa^Fpa, Gd, Aa, Aa, Aa, Aa, Gd, Aa^Fpa, Gll^Fp, Gd, Gll^Fp, Gll^Fp, Gll^Fp, Gll^Fp, Gll^Fp, Gll^Fp, Gll^Fp, Aa^Fpa, Aa^Fpa, Aa^Fpa, Aa^Fpa, Gll^Fp, Aa^Fpa, Gd
Gd, Gd, Aa, Gd, Gd, Gd, Aa^Fpa, Aa^Fpa, Gd, Mm, Mm, Hhd, Hhd, Aa, Aa, Gd, Aa^Fpa, Gll^Fp, Aa^Fpa, Gd, Gd, Aa, Gd, Gd, Aa^Fpa, Gll^Fp, Gll^Fp, Gll^Fp, Gll^Fp, Gll^Fp, Aa^Fpa, Gll^Fp, Gll^Fp, Gll^Fp, Aa^Fpa, Aa^Fpa, Aa^Fpa, Aa^Vha, Aa^Fpa, Aa^Fpa, Gd, Gd
Gd, Aa, Aa, Aa, Aa^Vha, Ww, Aa^Fpa, Aa^Fpa, Hhd, Hhd, Mm, Ha, Gd, Aa, Gd, Gd, Aa^Fpa, Gll^Fp, Aa^Fpa, Gd, Gd, Gd, Aa^Fpa, Aa^Fpa, Gll^Fp, Gd, Gd, Gll^Fp, Gll^Fp, Gd, Gll^Fp, Gll^Fp, Gd, Gll^Fp, Gll^Fp, Gll^Fp, Aa^Fpa, Aa^Fpa, Gd, Gd, Gd, Gd
Aa, Aa, Aa, Aa, Aa, Ww, Ww, Aa^Fpa, Gd, Gd, Gd, Ha, Gd, Gd, Gd, Aa^Fpa, Aa^Fpa, Gll^Fp, Gll^Fp, Aa^Fpa, Aa^Vha, Aa^Fpa, Gll^Fp, Gll^Fp, Gll^Fp, Gd^Vh, Gd, Gd, Gd, Gd, Gll^Fp, Gll^Fp, Gll^Fp, Gll^Fp, Gll^Fp, Gll^Fp, Aa^Fpa, Gd, Gd, Gd, Gd, Aa^Fpa
Ai, Ai, Ai, Ai, Ai, Ai, Ai, Ww, Ww, Gd, Gd, Gd, Gd, Gd, Aa^Fpa, Aa^Fpa, Gll^Fp, Gll^Fp, Gll^Fp, Aa^Fpa, Gd, Aa^Fpa, Gll^Fp, Gll^Fp, Gd, Gd, Gd, Gd, Gd, Gd, Gll^Fp, Aa^Fpa, Aa^Fpa, Gll^Fp, Gll^Fp, Gll^Fp, Aa^Fpa, Gd, Hhd, Gd, Aa^Fpa, Aa^Fpa
