Wo, Ww, Ww, Ww, Ww, Gd, Gd, Aa, Aa, Aa, Re, Aa^Fpa, Gll^Fp, Aa^Fpa, Re, Gd, Aa, Aa, Aa^Fpa, Aa^Fpa, Ww, Ww, Ww, Ww, Ww, Gd, Gd, Ai, Wo, Wo, Ww, Ai, Aa, Gd, Gd, Gd, Aa^Fpa, Aa^Fpa, Aa^Fpa, Gd, Aa, Aa
Ww, Ww, Ai, Ww, Ww, Aa, Aa, Aa, Aa, Aa, Aa, Re, Re, Re, Aa^Fpa, Re, Re, Gd, Gd, Aa^Fpa, Aa^Fpa, Ww, Aa^Fpa, Ww, Ai, Aa, Aa, Ai, Wo, Wo, Ww, Ai, Aa, Aa, Aa, Aa, Aa, Gd, Gd, Aa, Re, Re
Ww, Ai, Ww, Ww, Ai, Aa, Aa, Aa, Aa, Aa, Gd, Aa^Fpa, Aa^Fpa, Aa^Fpa, Aa^Fpa, Aa^Fpa, Aa^Fpa, Re, Re, Gd, Gd, Gd, Gd, Gd, Aa, Aa, Aa, Aa, Ww, Ww, Ai, Ai, Aa, Aa, Aa, Aa, Aa, Aa, Aa, Aa, Re, Aa
Ww, Ww, Wo, Ww, Ai, Aa, Aa, Aa, Aa, Aa, Gd, Aa^Fpa, Aa^Vha, Aa^Fpa, Aa^Fpa, Aa^Fpa, Aa^Fpa, Aa, Aa, Re, Re, Gd, Gd, Aa, Aa, Aa, Aa, Aa, Ai, Ai, Ww, Ch, Ch, Ch, Aa, Aa, Aa, Aa, Aa, Aa, Re, Aa
Ww, Ww, Wo, Ww, Ai, Ai, Aa, Aa, Aa, Aa, Gd, Aa^Fpa, Aa^Fpa, Aa^Fpa, Aa^Fpa, Aa^Fpa, Gd, Aa, Aa, Aa, Re, Gd^Vh, Gd, Aa, Aa, Aa, Re, Re, Re, Re, Re, Ch, 2 Kh, Ch, Re, Re, Re, Aa, Aa, Aa, Re, Aa
Aa^Fpa, Ww, Ww, Ww, Ai, Aa, Aa, Aa, Aa, Aa, Gd, Aa^Fpa, Aa^Fpa, Aa^Fpa, Aa^Fpa, Gd, Gd, Aa, Aa, Aa, Re, Gd, Aa, Aa, Aa, Re, Aa^Vha, Aa, Aa, Aa, Ch, Ch, Ch, Gd, Gd, Aa, Aa, Re, Re, Aa, Re, Aa
Aa^Fpa, Aa^Fpa, Ww, Ww, Ai, Aa, Aa, Aa, Gd, Gd, Aa^Fpa, Aa^Fpa, Gd, Aa^Fpa, Gd, Aa^Fpa, Aa, Aa, Aa, Gd, Gd, Re, Re, Aa, Re, Re, Aa, Aa, Aa, Aa, Gd, Gd, Gd, Gd, Gd, Aa, Aa, Gd, Gd, Re, Aa, Aa
Aa, Aa, Ai, Wo, Ww, Ai, Aa, Gd, Gd, Gd, Gd, Gd, Gd, Aa, Aa, Aa, Aa, Aa, Aa, Aa, Gd, Aa, Aa, Re, Aa, Aa, Aa, Aa, Aa, Gd, Aa, Aa, Aa, Aa, Aa, Gd, Gd, Aa^Fpa, Aa^Fpa, Re, Re, Aa
Aa, Aa, Aa, Ai, Ai, Aa^Vha, Gd, Aa^Fpa, Gd, Gd, Ww, Ww, Ai, Aa, Aa, Aa, Aa, Aa, Aa, Aa, Aa, Aa, Ai, Re, Aa, Ai, Aa, Aa, Aa, Aa, Aa, Aa, Aa, Ai, Aa, Gd, Aa^Fpa, Aa^Fpa, Gd, Gd, Re, Aa
Gd, Gd, Aa, Aa, Aa, Aa, Gd, Aa^Fpa, Gd, Gd^Vh, Ww, Ww, Ww, Aa, Aa, Gd, Aa, Aa, Aa, Aa, Aa, Aa, Aa, Re, Ai, Ai, Ai, Ai, Ai, Gd, Aa, Aa, Aa^Vha, Ai, Ai, Gd, Gd, Gd, Gd, Aa, Re, Re
Hhd, Aa^Fpa, Gd, Gd, Gd, Gd, Gd, Gd, Gd, Gd, Gd, Aa, Ai, Gd, Gd, Gd, Aa, Aa, Aa, Aa, Aa, Aa, Re, Re, Aa, Ai, Ai, Ww, Ww, Ww, Ww, Ww, Ww, Ww, Ww, Aa, Aa, Aa, Aa^Vha, Re, Ha, Aa
Hhd, Aa^Fpa, Gd, Aa, Gd, Aa, Aa, Gd, Gd, Gd, Aa, Aa, Aa, Aa, Gd, Gd^Vh, Aa, Aa, Aa, Aa, Aa, Aa, Re, Gd, Gd^Vh, Ww, Ww, Ww, Ww, Ww, Ww, Ww, Ww, Ww, Gd, Gd, Aa, Aa, Re, Re, Ha, Ha
Aa^Fpa, Aa^Fpa, Aa, Aa^Vha, Aa, Aa, Aa, Aa, Gd, Aa, Aa, Aa, Aa, Aa, Aa, Ww, Ai, Aa, Aa, Aa, Gd, Aa, Re, Aa^Fpa, Aa^Fpa, Ww, Ww, Ww, Ww, Ww, Aa^Fpa, Aa^Fpa, Aa^Fpa, Aa^Fpa, Gd, Aa, Aa, Re, Aa, Aa, Ha, Aa
Hhd, Hhd, Ha, Aa, Aa, Aa, Aa, Aa, Aa, Aa, Aa, Aa, Aa, Aa, Aa, Ai, Ww, Aa, Aa, Aa, Gd, Aa, Re, Aa^Fpa, Aa^Fpa, Ww, Ww, Ww, Ww, Aa^Fpa, Aa^Fpa, Aa^Fpa, Aa^Vha, Aa^Fpa, Gd, Aa, Aa, Re, Aa, Aa, Aa, Aa
Ha, Ha, Ha, Ha, Aa, Aa, Aa^Vha, Aa, Aa, Aa, Aa, Aa, Aa, Aa, Aa, Ai, Aa, Gd, Aa, Aa, Aa, Aa, Re, Aa^Fpa, Aa^Fpa, Gll^Fp, Ww, Ww, Aa^Fpa, Aa^Fpa, Gd, Gd, Gd, Gd, Gd, Aa, Aa, Re, Re, Aa, Aa, Aa
Aa, Aa, Aa, Aa, Aa, Aa, Aa, Aa, Aa, Aa, Aa, Aa, Aa, Aa, Gd, Gd, Gd, Gd, Gd, Aa, Aa, Aa, Re, Gd, Aa^Fpa, Aa^Fpa, Aa^Vha, Aa^Fpa, Aa^Fpa, Gd, Gd, Gd, Aa, Aa, Aa, Aa, Aa, Aa, Aa^Vha, Re, Aa, Aa
Aa, Aa, Aa, Aa, Aa, Aa, Aa, Ha, Aa, Aa, Aa, Aa, Aa, Aa, Gd, Gd^Vh, Gd, Gd, Aa, Aa, Aa, Re, Aa, Aa, Gd, Aa^Fpa, Aa^Fpa, Aa^Fpa, Aa^Fpa, Aa, Aa, Aa, Aa, Aa, Aa, Aa, Aa, Aa, Aa, Re, Aa, Aa
Aa, Aa, Gd, Gd, Gd, Aa, Aa, Aa, Ha, Aa, Aa, Aa, Gd, Aa, Aa, Gd, Gd, Aa, Aa, Aa, Aa, Re, Aa, Aa, Aa, Gd, Aa^Fpa, Aa^Fpa, Gd, Aa, Aa, Aa, Ai, Ai, Aa, Ai, Aa, Aa, Aa, Re, Aa, Ai
Aa, Gd, Aa^Fpa, Aa^Fpa, Aa^Fpa, Gd, Aa, Aa, Aa, Aa, Aa, Aa, Aa, Gd, Aa, Aa, Aa, Aa, Aa, Aa, Aa, Re, Aa, Aa, Aa, Gd, Aa^Fpa, Aa^Fpa, Gd, Gd, Gd, Aa, Ai, Ai, Ai, Ai, Ai, Ai, Ai, Re, Aa, Aa
Gd, Aa^Fpa, Aa^Vha, Aa^Fpa, Aa^Fpa, Aa^Fpa, Gd, Aa, Aa, Aa, Aa, Aa, Aa, Aa, Gd, Aa, Aa, Aa, Aa, Aa, Aa, Re, Re, Aa, Aa, Gd, Aa^Fpa, Aa^Fpa, Aa^Fpa, Aa^Fpa, Aa^Fpa, Ai, Ai, Ww, Ww, Ww, Ai, Aa, Aa, Re, Re, Aa
Gd, Aa^Fpa, Aa^Fpa, Gll^Fp, Gll^Fp, Aa^Fpa, Gd, Gd, Aa, Aa, Aa, Aa, Aa, Aa, Gd, Aa, Aa, Aa, Aa, Aa, Aa, Aa^Vha, Re, Aa, Aa, Gd, Aa^Fpa, Gll^Fp, Gll^Fp, Ww, Ww, Ww, Ww, Ww, Wo, Wo, Ai, Aa, Aa, Ai, Aa, Re
Gd, Aa^Fpa, Aa^Fpa, Gll^Fp, Gll^Fp, Aa^Fpa, Aa^Fpa, Aa^Fpa, Aa, Aa, Aa, Aa, Aa, Aa, Gd, Gd, Gd, Gd, Gd, Aa, Aa, Re, Aa, Aa, Aa, Gd, Aa^Fpa, Gll^Fp, Gd, Gd^Vh, Gll^Fp, Aa^Fpa, Ww, Ww, Wo, Wo, Ai, Ai, Ai, Aa, Aa, Aa
Gd, Aa^Fpa, Aa^Fpa, Aa^Fpa, Aa^Fpa, Aa^Fpa, Aa^Fpa, Gd, Aa, Aa, Aa, Aa, Aa, Aa, Aa, Aa^Fpa, Aa^Fpa, Aa^Fpa, Gd, Gd, Aa, Re, Aa, Aa, Aa, Gd, Aa^Fpa, Gll^Fp, Gd, Gd, Gll^Fp, Aa^Fpa, Aa^Fpa, Ww, Ww, Ww, Ai, Ai, Ai, Ai, Aa, Gd
Aa, Aa, Gd, Gd, Gd, Gd, Gd, Gd, Aa^Vha, Aa, Aa, Aa, Aa, Aa, Aa, Gd, Aa^Fpa, Aa^Vha, Aa^Fpa, Aa^Fpa, Re, Re, Aa, Aa, Ha, Ha, Aa^Fpa, Aa^Fpa, Gd, Gll^Fp, Aa^Fpa, Aa^Fpa, Gd, Gd^Vh, Ww, Ai, Ai, Ai, Ai, Ai, Aa^Vha, Re
Aa, Aa, Aa, Aa, Gd, Aa, Aa, Aa, Gd, Aa, Aa, Aa, Aa, Aa, Aa, Gd, Gd, Aa^Fpa, Aa^Fpa, Aa^Fpa, Re, Gd, Gd, Ha, Ms, Ms, Mm, Mm, Hhd, Aa^Fpa, Aa^Fpa, Gd, Aa, Gd, Gd, Aa, Aa, Aa, Aa, Aa, Aa, Re
Aa, Aa, Aa, Aa, Aa, Aa, Aa, Aa, Gd, Aa, Aa, Aa, Aa, Ai, Ai, Ai, Aa, Gd, Aa^Fpa, Aa^Fpa, Re, Aa^Fpa, Hhd, Ms, Ms, Ms, Ms, Mm, Mm, Gd, Gd, Aa, Aa, Gd, Aa, Aa, Aa, Aa, Aa, Aa, Aa, Re
Aa, Aa^Vha, Aa, Gd, Aa, Aa, Aa, Aa, Aa, Aa, Aa, Aa, Ai, Aa, Ai, Ai, Aa, Aa, Re, Re, Gll^Fp, Aa^Fpa, Mm, Mm, Ms, Ms, Ms, Mm, Mm, Hhd, Gd, Aa, Aa, Gd, Aa, Aa, Aa, Aa, Aa, Aa, Re, Re
Gd, Hhd, Aa, Aa, Gd, Aa, Aa, Aa, Aa, Aa, Aa, Aa, Ai, Ai, Ai, Ai, Aa, Aa, Re, Aa^Fpa, Aa^Fpa, Hhd, Mm, Mm, Mm, Mm, Ms, Mm, Mm, Gd, Aa^Fpa, Aa^Fpa, Aa^Fpa, Gd, Gd, Aa, Aa, Aa, Aa, Aa, Re, Aa
Mm, Ms, Ms, Ha, Aa, Aa, Aa^Vha, Aa, Aa, Aa, Aa, Aa, Ai, Ai, Ai, Aa, Aa, Aa, Re, Aa^Fpa, Aa^Fpa, Hhd, Mm, Mm, Mm, Mm, Mm, Mm, Hhd, Aa^Vha, Aa^Fpa, Gll^Fp, Aa^Fpa, Aa^Fpa, Gd, Gd, Aa, Aa, Aa, Gd, Re, Gd
Ms, Ms, Ms, Ha, Ha, Aa, Aa, Aa, Aa, Aa, Aa, Aa, Aa, Aa, Aa, Aa, Aa, Re, Aa^Fpa, Aa^Vha, Aa^Fpa, Hhd, Mm, Mm, Mm, Mm, Mm, Hhd, Aa^Fpa, Aa^Fpa, Aa^Vha, Aa^Fpa, Gll^Fp, Aa^Fpa, Aa^Fpa, Hhd, Hhd, Ha, Gd, Aa^Fpa, Aa^Fpa, Re
Mm, Mm, Ms, Ha, Ha, Aa, Aa, Aa, Aa, Aa, Aa, Aa, Aa, Aa, Aa, Aa, Aa, Re, Aa^Fpa, Aa^Fpa, Aa^Fpa, Aa^Fpa, Hhd, Hhd, Hhd, Gd, Gd, Gd, Aa^Fpa, Aa^Fpa, Aa^Fpa, Aa^Fpa, Aa^Fpa, Gll^Fp, Aa^Fpa, Hhd, Mm, Hhd, Aa^Fpa, Aa^Fpa, Aa^Fpa, Aa^Fpa
Mm, Mm, Ha, Ha, Aa, Aa, Aa, Aa, Aa, Aa, Aa, Aa, Aa, Aa, Gd, Gd, Aa, Re, Aa^Fpa, Aa^Fpa, Aa^Fpa, Aa^Fpa, Gd, Gd, Gd, Aa, Aa, Aa, Aa, Aa, Aa^Fpa, Gd, Aa^Fpa, Aa^Fpa, Aa^Fpa, Hhd, Hhd, Ha, Aa^Fpa, Gll^Fp, Aa^Fpa, Aa^Fpa
Hhd, Hhd, Ha, Gd, Aa, Aa, Aa, Aa, Aa, Aa, Aa, Aa, Aa, Ha, Aa, Gd, Re, Re, Aa^Vha, Aa^Fpa, Aa^Vha, Gd, Aa, Aa, Aa, Aa, Aa, Aa, Aa, Aa, Aa, Aa, Gd, Gd, Gd, Hhd, Ha, Gd, Aa^Fpa, Aa^Fpa, Aa^Vha, Aa^Fpa
Aa^Fpa, Aa^Fpa, Aa^Fpa, Gd, Aa, Aa, Aa, Aa, Aa, Aa, Aa, Aa, Ha, Ha, Ha, Re, Gd, Aa^Fpa, Aa^Fpa, Gd, Aa, Aa, Aa, Aa, Aa^Vha, Aa, Aa, Aa, Aa, Aa, Aa, Aa, Aa, Aa, Aa, Aa, Aa, Gd, Gd, Gd, Aa^Fpa, Aa^Fpa
Aa^Fpa, Aa^Vha, Aa^Fpa, Aa^Fpa, Gd, Aa, Aa, Aa, Aa, Aa, Aa, Ha, Ha, Ha, Ha, Re, Gd, Gd, Gd, Aa, Aa, Aa, Aa, Aa, Aa, Aa, Aa, Aa, Aa, Aa, Aa, Aa, Aa, Aa, Aa, Aa, Aa, Aa, Aa^Fpa, Aa^Fpa, Aa^Fpa, Aa^Fpa
Aa^Fpa, Aa^Fpa, Aa^Fpa, Aa^Fpa, Gd, Aa, Ai, Aa, Aa, Gd, Aa, Aa, Ha, Ch, Ch, Ch, Gd, Aa^Fpa, Aa^Fpa, Aa^Fpa, Aa, Aa, Aa, Aa, Aa, Aa, Aa, Aa, Aa, Aa, Aa, Aa^Vha, Aa, Aa, Aa, Aa, Aa, Aa, Aa^Fpa, Gll^Fp, Gll^Fp, Re
Aa^Fpa, Aa^Fpa, Aa^Fpa, Gd, Gd, Gd, Gd, Gd, Gd, Gd, Gd, Aa, Ha, Ch, 1 Kh, Ch, Aa^Fpa, Aa^Fpa, Gll^Fp, Gll^Fp, Aa^Fpa, Aa^Fpa, Gd, Gd, Aa, Aa, Aa, Aa, Aa, Aa, Aa, Aa, Aa, Aa, Aa, Aa, Aa, Aa, Aa^Fpa, Gll^Fp, Aa^Fpa, Aa^Fpa
Gd, Gd, Gd, Aa, Aa, Gd, Aa^Fpa, Aa^Fpa, Aa^Fpa, Gd, Gd, Gd, Ch, Ch, Ch, Hhd, Aa^Vha, Aa^Fpa, Gll^Fp, Gd, Gll^Fp, Aa^Fpa, Aa^Fpa, Aa^Fpa, Aa, Ha, Ha, Ha, Ha, Aa, Aa, Aa, Aa, Aa, Gd, Aa, Gd, Gd, Aa^Fpa, Aa^Fpa, Aa^Fpa, Aa^Fpa
Gd, Gd, Gd, Gd, Aa, Gd, Aa^Fpa, Aa^Vha, Aa^Fpa, Aa^Fpa, Aa^Fpa, Hhd, Hhd, Hhd, Re, Hhd, Aa^Fpa, Aa^Fpa, Gd, Gd, Gd, Gd, Aa^Fpa, Aa^Fpa, Ha, Ms, Ms, Ms, Ha, Aa, Aa, Aa, Gd, Gd, Aa^Fpa, Aa^Fpa, Gll^Fp, Gll^Fp, Aa^Fpa, Aa^Vha, Aa^Fpa, Gd
Aa, Aa, Gd, Gd, Gd, Gd, Aa^Fpa, Aa^Fpa, Aa^Fpa, Aa^Fpa, Hhd, Mm, Re, Re, Mm, Mm, Aa^Fpa, Gll^Fp, Gd^Vh, Gd, Gd, Gd, Gll^Fp, Aa^Fpa, Ha, Ms, Ms, Ms, Ms, Aa, Aa, Aa, Gd, Aa^Fpa, Gll^Fp, Gll^Fp, Gd, Gll^Fp, Aa^Fpa, Aa^Fpa, Aa^Fpa, Gd
Aa, Aa, Gd, Gd, Gd, Gd, Aa^Fpa, Aa^Fpa, Gll^Fp, Hhd, Re, Re, Mm, Mm, Mm, Hhd, Hhd, Gd, Gd, Gd, Gd, Gd, Aa^Fpa, Aa^Fpa, Ha, Ms, Ms, Ms, Ha, Aa, Aa, Aa, Gd, Aa^Fpa, Gd, Gd, Gd, Gll^Fp, Aa^Fpa, Aa^Fpa, Re, Aa^Fpa
Aa, Gd, Gd, Gd, Aa, Aa, Aa^Fpa, Aa^Fpa, Aa^Fpa, Re, Mm, Mm, Mm, Mm, Mm, Hhd, Hhd, Gd, Gd, Gd, Gd, Gd, Gll^Fp, Aa^Fpa, Ha, Ha, Ha, Ha, Ha, Ha, Ha, Ha, Aa^Fpa, Aa^Fpa, Gll^Fp, Gd, Gll^Fp, Re, Re, Re, Aa^Fpa, Re
