Re, Gll^Fp, Gll^Fp, Gll^Fp, Gll^Fp, Gll^Fp, Aa^Fpa, Gd, Aa^Fpa, Aa^Fpa, Aa^Fpa, Gll^Fp, Gll^Fp, Gll^Fp, Aa^Fpa, Aa^Fpa, Aa^Fpa, Gll^Fp, Gd, Gd, Gd, Gll^Fp, Mm, Mm, Mm, Mm, Mm, Gll^Fp, Gll^Fp, Gll^Fp, Aa^Fpa, Gd, Aa, Aa, Aa, Gd, Aa^Fpa, Gll^Fp, Gll^Fp, Gll^Fp, Aa^Fpa, Aa^Fpa
Gd, Re, Gll^Fp, Gd, Gd, Gll^Fp, Aa^Fpa, Gd, Aa^Fpa, Aa^Fpa, Aa^Fpa, Gll^Fp, Gll^Fp, Aa^Fpa, Aa^Fpa, Aa^Fpa, Aa^Fpa, Aa^Fpa, Ww, Gll^Fp, Gll^Fp, Hhd, Mm, Mm, Mm, Mm, Mm, Hhd, Aa^Fpa, Gll^Fp, Aa^Fpa, Aa^Fpa, Aa^Fpa, Gd, Aa, Ha, Hhd, Aa^Fpa, Aa^Fpa, Gd, Aa, Gd
Gd, Re, Gd, Gd, Hhd, Hhd, Hhd, Ha, Aa^Vha, Aa^Fpa, Aa^Fpa, Gll^Fp, Aa^Fpa, Aa^Fpa, Gll^Fp, Gll^Fp, Aa^Fpa, Aa^Fpa, Gll^Fp, Aa^Fpa, Aa^Fpa, Hhd, Mm, Mm, Mm, Mm, Mm, Hhd, Hhd, Aa^Fpa, Aa^Fpa, Aa^Fpa, Aa^Fpa, Aa^Fpa, Hhd, Hhd, Ww, Ww, Ww, Ha, Aa, Aa
Re, Re, Gd, Ch, Ch, Ch, Mm, Ms, Ms, Hhd, Hhd, Hhd, Aa^Fpa, Aa^Fpa, Aa^Fpa, Gll^Fp, Aa^Fpa, Aa^Fpa, Aa^Fpa, Aa^Fpa, Aa^Vha, Hhd, Mm, Mm, Mm, Mm, Ms, Hhd, Hhd, Aa^Fpa, Aa^Fpa, Gd, Aa^Fpa, Aa^Fpa, Hhd, Ww, Ww, Ww, Ww, Ww, Aa, Aa
Re, Gd^Vh, Re, Ch, 1 Kh, Ch, Ms, Mm, Mm, Mm, Ha, Ha, Ha, Ha, Aa^Fpa, Gll^Fp, Gll^Fp, Aa^Fpa, Aa^Fpa, Aa, Aa, Hhd, Hhd, Mm, Mm, Mm, Ms, Hhd, Hhd, Aa^Fpa, Gd, Aa, Gd, Aa^Fpa, Hhd, Ww, Ww, Ww, Ww, Ww, Aa^Fpa, Aa^Fpa
Re, Re, Ch, Ch, Ch, Mm, Ms, Mm, Mm, Mm, Ha, Ha, Ms, Ha, Aa^Vha, Aa^Fpa, Aa^Fpa, Aa^Fpa, Aa, Aa, Aa, Ha, Ha, Ms, Hhd, Hhd, Mm, Hhd, Hhd, Gd, Aa, Aa, Aa^Fpa, Gll^Fp, Hhd, Ww, Ww, Ww, Ww, Ww, Gll^Fp, Gd
Re, Gll^Fp, Hhd, Mm, Mm, Mm, Mm, Mm, Mm, Mm, Ha, Ha, Ha, Gd, Aa^Fpa, Aa^Fpa, Aa^Fpa, Gd, Aa, Aa, Aa, Ha, Ha, Aa, Gd, Hhd, Hhd, Hhd, Hhd, Aa, Gd, Gd, Aa^Fpa, Gd, Gd^Vh, Ww, Hhd, Hhd, Hhd, Ww, Gd, Gd
Aa^Fpa, Re, Hhd, Mm, Mm, Mm, Mm, Mm, Mm, Ms, Ha, Ha, Aa, Gd, Aa^Fpa, Aa^Fpa, Aa^Fpa, Aa, Aa, Aa, Ha, Ha, Aa, Aa, Gd, Aa^Fpa, Hhd, Hhd, Hhd, Aa^Fpa, Aa^Fpa, Aa^Fpa, Gll^Fp, Gd, Hhd, Hhd, Hhd, Hhd, Gd, Ww, Ww, Ww
Aa, Re, Re, Mm, Mm, Hhd, Mm, Mm, Mm, Hhd, Ha, Aa, Gd, Gd, Gd, Gd, Gd, Aa, Aa, Aa, Aa, Aa^Fpa, Aa, Aa, Aa^Fpa, Aa^Fpa, Aa^Vha, Hhd, Hhd, Hhd, Gll^Fp, Gll^Fp, Gd, Gd, Hhd, Hhd, Hhd, Gll^Fp, Gll^Fp, Ww, Gd^Vh, Ww
Ai, Ai, Ai, Re, Re, Gll^Fp, Gd, Hhd, Hhd, Aa^Fpa, Gd, Gd, Gd, Gd, Gd, Aa^Fpa, Gd, Aa, Aa, Aa, Aa^Fpa, Aa^Fpa, Aa^Vha, Aa^Fpa, Gd, Aa^Fpa, Gd, Ha, Ha, Hhd, Hhd, Gd, Gd, Gd, Gd, Gll^Fp, Gll^Fp, Gll^Fp, Gll^Fp, Gll^Fp, Gll^Fp, Gll^Fp
Ha, Aa, Ai, Ai, Re, Aa^Vha, Aa^Fpa, Aa^Fpa, Aa^Fpa, Aa^Fpa, Aa^Fpa, Aa^Fpa, Gd, Gd, Aa^Fpa, Aa^Fpa, Aa^Fpa, Gd, Gd, Aa^Fpa, Gll^Fp, Gd, Aa^Fpa, Aa^Fpa, Aa^Fpa, Aa^Fpa, Hhd, Ha, Ha, Hhd, Hhd, Hhd, Gd, Gd, Gll^Fp, Gll^Fp, Gll^Fp, Gll^Fp, Aa^Fpa, Aa^Fpa, Aa^Fpa, Aa^Fpa
Ai, Ai, Ai, Aa, Aa, Re, Re, Aa, Gd, Aa^Fpa, Aa^Vha, Aa^Fpa, Aa^Fpa, Aa^Vha, Aa^Fpa, Gll^Fp, Gll^Fp, Aa^Fpa, Aa^Fpa, Gll^Fp, Gd, Gll^Fp, Gll^Fp, Gll^Fp, Gll^Fp, Aa^Fpa, Hhd, Hhd, Ha, Hhd, Hhd, Gd, Gll^Fp, Gll^Fp, Aa^Fpa, Aa^Fpa, Aa^Fpa, Aa^Fpa, Aa^Fpa, Aa^Fpa, Aa^Fpa, Aa^Fpa
Ai, Ai, Ai, Aa, Aa, Aa, Re, Aa, Gd, Aa^Fpa, Re, Aa^Fpa, Gll^Fp, Aa^Fpa, Gll^Fp, Gll^Fp, Gll^Fp, Gll^Fp, Aa^Fpa, Gll^Fp, Gll^Fp, Gll^Fp, Gll^Fp, Gll^Fp, Gd^Vh, Gll^Fp, Hhd, Mm, Hhd, Hhd, Hhd, Aa^Fpa, Aa^Fpa, Aa^Fpa, Gd, Aa, Aa, Gd, Aa^Fpa, Aa^Vha, Aa^Fpa, Aa^Fpa
Aa, Ai, Ai, Aa, Aa, Aa, Aa, Re, Re, Re, Ai, Re, Re, Gll^Fp, Gll^Fp, Gll^Fp, Gll^Fp, Aa^Fpa, Aa^Fpa, Aa^Fpa, Aa^Fpa, Gll^Fp, Gd, Gd, Gd, Hhd, Mm, Mm, Hhd, Hhd, Aa^Fpa, Aa^Fpa, Aa^Vha, Aa^Fpa, Aa^Fpa, Aa, Aa, Gd, Gll^Fp, Gll^Fp, Gll^Fp, Gll^Fp
Gd, Gd, Aa, Ai, Ai, Aa, Aa, Aa, Aa, Ai, Ai, Gd, Re, Aa^Fpa, Gll^Fp, Gll^Fp, Aa^Fpa, Aa^Fpa, Aa^Fpa, Aa^Fpa, Aa^Fpa, Aa^Fpa, Gll^Fp, Hhd, Mm, Mm, Mm, Mm, Aa^Fpa, Aa^Fpa, Gd, Gd, Aa^Fpa, Aa^Fpa, Aa^Fpa, Gd, Aa, Gd, Aa^Fpa, Gll^Fp, Gd, Gd
Hhd, Gd, Aa, Aa, Ai, Ai, Ai, Ai, Ai, Ai, Aa, Aa, Re, Aa^Fpa, Aa^Fpa, Aa^Fpa, Aa^Fpa, Aa^Fpa, Gd, Gd, Aa, Gd, Hhd, Mm, Mm, Mm, Mm, Hhd, Hhd, Aa^Fpa, Aa^Fpa, Gd, Gd, Aa^Fpa, Aa^Fpa, Aa^Fpa, Aa, Aa, Aa^Fpa, Gd, Gd, Gll^Fp
Ha, Gd, Aa, Aa, Aa, Aa, Aa, Ai, Aa, Aa, Aa, Aa, Re, Re, Re, Aa^Vha, Aa^Fpa, Gd, Aa, Aa, Aa^Vha, Aa, Hhd, Mm, Mm, Mm, Mm, Ha, Aa^Fpa, Gd, Gd, Gd, Gd, Gd, Aa, Aa, Aa, Aa, Aa^Fpa, Aa^Fpa, Aa^Fpa, Aa^Fpa
Ha, Aa, Aa, Aa, Aa, Aa, Aa, Aa, Aa, Aa, Gd, Re, Hhd, Hhd, Aa^Fpa, Re, Aa^Fpa, Aa, Aa, Aa, Aa, Gd, Mm, Mm, Mm, Mm, Mm, Ha, Aa, Aa, Aa, Aa, Aa^Fpa, Aa, Aa, Gd, Gd, Gd, Aa^Fpa, Aa^Fpa, Aa^Fpa, Aa^Fpa
Ha, Aa, Aa, Aa, Aa, Ai, Ai, Aa, Aa, Aa, Re, Re, Hhd, Hhd, Aa^Fpa, Re, Aa, Aa, Aa, Aa, Aa, Ha, Hhd, Mm, Mm, Mm, Mm, Ha, Aa, Aa^Vha, Aa, Aa, Aa, Aa, Aa, Aa^Fpa, Aa^Fpa, Hhd, Aa^Fpa, Aa^Fpa, Aa^Fpa, Aa^Fpa
Aa, Aa, Gd, Aa, Aa, Ai, Ai, Aa, Re, Re, Aa, Aa^Fpa, Hhd, Aa^Fpa, Aa^Fpa, Re, Re, Aa, Aa^Fpa, Gd, Gd, Ha, Mm, Mm, Mm, Mm, Mm, Ha, Aa, Aa, Aa, Aa, Aa, Aa, Gd, Aa^Vha, Hhd, Hhd, Hhd, Gll^Fp, Aa^Fpa, Aa^Fpa
Aa, Aa^Vha, Gd, Gd, Aa, Ai, Ai, Re, Aa, Gd, Aa^Vha, Aa^Fpa, Aa^Fpa, Gll^Fp, Aa^Fpa, Gd, Re, Aa, Aa, Aa^Fpa, Aa^Fpa, Ww, Mm, Mm, Mm, Mm, Mm, Ms, Ha, Aa, Aa, Aa, Gd, Gd, Aa^Fpa, Aa^Fpa, Hhd, Hhd, Hhd, Gll^Fp, Aa^Fpa, Aa^Fpa
Aa, Aa, Aa, Aa, Aa, Aa, Re, Re, Aa, Aa^Fpa, Aa^Fpa, Aa^Fpa, Aa^Fpa, Aa^Fpa, Aa^Fpa, Gd, Aa, Re, Aa, Ww, Ww, Ww, Ww, Mm, Mm, Mm, Mm, Mm, Ms, Ha, Aa, Gd, Aa^Fpa, Aa^Fpa, Aa^Fpa, Aa^Fpa, Hhd, Hhd, Hhd, Gll^Fp, Gll^Fp, Aa^Fpa
Aa, Aa, Aa, Aa, Re, Re, Aa, Aa, Gd, Gd, Aa^Fpa, Gll^Fp, Aa^Fpa, Aa^Fpa, Aa^Fpa, Gd, Aa, Re, Aa, Gd, Ww, Ww, Ww, Ww, Mm, Mm, Mm, Mm, Ms, Ms, Ha, Aa^Fpa, Aa^Fpa, Aa^Fpa, Aa^Fpa, Aa^Fpa, Hhd, Hhd, Hhd, Aa^Fpa, Gll^Fp, Gll^Fp
Re, Re, Re, Re, Aa, Aa, Aa, Aa, Aa, Aa, Aa^Fpa, Aa^Fpa, Gll^Fp, Aa^Fpa, Aa^Fpa, Aa^Fpa, Aa, Re, Re, Gd, Ww, Ww, Ww, Ww, Mm, Mm, Mm, Mm, Ms, Ha, Hhd, Aa^Fpa, Aa^Fpa, Aa^Fpa, Aa^Fpa, Aa^Fpa, Aa^Fpa, Ha, Gd, Aa^Vha, Aa^Fpa, Aa^Fpa
Gd, Aa, Aa, Aa, Aa, Gd, Aa^Fpa, Gd, Aa, Gd, Aa^Vha, Gll^Fp, Gll^Fp, Gll^Fp, Aa^Fpa, Aa^Fpa, Gd, Aa, Re, Ai, Ww, Ww, Ww, Hhd, Hhd, Ha, Ms, Mm, Mm, Hhd, Hhd, Gll^Fp, Aa^Fpa, Aa^Fpa, Aa^Fpa, Aa^Fpa, Gd, Aa, Aa, Gd, Gd, Gd
Gd, Aa, Aa, Gd, Gd, Aa^Fpa, Aa^Fpa, Gd, Aa, Gd, Aa^Fpa, Aa^Fpa, Gll^Fp, Aa^Fpa, Aa^Vha, Aa^Fpa, Gd, Aa, Aa, Re, Ai, Ww, Aa^Vha, Aa^Fpa, Gd, Aa, Ha, Hhd, Mm, Hhd, Hhd, Gll^Fp, Aa^Fpa, Aa^Fpa, Aa^Fpa, Aa^Fpa, Aa^Fpa, Gd, Aa, Ha, Ha, Ha
Hhd, Ha, Gd, Gd, Aa^Fpa, Aa^Vha, Aa^Fpa, Aa^Fpa, Aa^Fpa, Gll^Fp, Gd, Gd, Aa^Fpa, Aa^Fpa, Aa^Fpa, Aa^Fpa, Gd, Aa, Aa, Re, Ai, Gd, Gd, Aa, Aa, Aa, Aa, Aa^Fpa, Hhd, Hhd, Gd, Gd, Aa^Fpa, Aa^Vha, Aa^Fpa, Aa^Fpa, Aa^Fpa, Aa^Fpa, Aa^Fpa, Aa^Fpa, Ha, Ha
Hhd, Hhd, Ha, Ha, Gd, Aa^Fpa, Gd, Aa^Fpa, Gd, Gd, Gd, Gd, Aa^Fpa, Ha, Ha, Hhd, Ha, Ha, Aa, Re, Ai, Aa, Aa, Aa, Aa, Aa, Aa, Aa^Fpa, Gll^Fp, Gd, Gd, Gd, Gd, Aa^Fpa, Aa^Fpa, Aa^Fpa, Aa^Fpa, Aa^Fpa, Aa^Fpa, Aa^Fpa, Aa, Ha
Ms, Ha, Hhd, Ha, Gd, Aa^Fpa, Aa^Fpa, Gll^Fp, Gd, Gd, Gd, Gd, Hhd, Ha, Hhd, Hhd, Hhd, Hhd, Gd, Re, Ai, Gd, Gd, Gd, Gd, Gd, Aa, Aa^Fpa, Aa^Vha, Gll^Fp, Gd, Gd, Gd, Gll^Fp, Gd, Gd, Aa^Fpa, Aa^Fpa, Aa^Fpa, Aa^Fpa, Re, Re
Ha, Aa, Aa^Fpa, Aa^Fpa, Aa^Fpa, Aa^Fpa, Aa^Fpa, Aa^Fpa, Gd, Gd, Gd, Gll^Fp, Hhd, Hhd, Mm, Hhd, Hhd, Gd, Aa^Vha, Re, Re, Ai, Aa^Fpa, Aa^Fpa, Aa^Fpa, Gd, Aa, Gd, Aa^Fpa, Aa^Fpa, Gll^Fp, Gd, Gd, Gll^Fp, Aa^Fpa, Aa^Fpa, Aa^Vha, Aa^Fpa, Aa^Fpa, Aa^Fpa, Re, Aa
Ha, Ha, Aa^Fpa, Aa^Fpa, Aa^Fpa, Aa^Fpa, Aa^Fpa, Aa^Fpa, Gll^Fp, Gll^Fp, Gll^Fp, Aa^Fpa, Aa^Fpa, Hhd, Hhd, Hhd, Gd, Gd, Gd, Aa^Fpa, Re, Ai, Aa^Fpa, Gll^Fp, Aa^Fpa, Gd, Aa, Aa, Gd, Aa^Fpa, Gll^Fp, Gd, Gll^Fp, Aa^Fpa, Ww, Aa^Fpa, Aa^Fpa, Aa^Fpa, Re, Re, Gd, Gd
Hhd, Hhd, Aa^Fpa, Gll^Fp, Aa^Fpa, Aa^Vha, Aa^Fpa, Aa^Vha, Gd, Gd, Gd, Gd, Aa, Aa, Aa^Fpa, Gll^Fp, Gd, Gd, Gd, Aa^Fpa, Re, Ai, Re, Re, Re, Aa, Re, Aa, Re, Re, Re, Aa^Fpa, Aa^Fpa, Gd, Gd, Gd, Re, Re, Gd, Gd, Aa^Fpa, Aa^Fpa
Aa^Fpa, Aa^Fpa, Aa^Fpa, Gll^Fp, Aa^Fpa, Aa^Fpa, Gd, Aa, Aa, Aa, Aa, Aa, Aa, Gd, Gll^Fp, Gll^Fp, Gd, Gll^Fp, Gll^Fp, Aa^Fpa, Ww, Ww, Aa^Fpa, Aa^Fpa, Aa^Fpa, Re, Aa, Re, Gd, Aa^Fpa, Aa^Fpa, Re, Re, Gd, Aa, Gd, Re, Aa^Fpa, Aa^Fpa, Aa^Fpa, Aa^Fpa, Aa^Fpa
Aa^Fpa, Aa^Fpa, Aa^Fpa, Aa^Fpa, Aa^Fpa, Gd, Aa, Aa, Aa, Aa, Aa, Aa, Aa, Gd, Gll^Fp, Gll^Fp, Gd, Gll^Fp, Aa^Fpa, Ww, Aa^Fpa, Aa^Vha, Aa^Fpa, Aa^Fpa, Aa, Aa, Aa, Ha, Hhd, Aa^Fpa, Aa^Fpa, Aa^Fpa, Aa^Fpa, Re, Re, Aa^Fpa, Re, Aa^Fpa, Aa^Fpa, Aa^Fpa, Gll^Fp, Gll^Fp
Gd, Gd, Aa^Fpa, Gd, Aa, Aa, Aa, Aa, Aa, Ai, Aa, Ai, Aa, Ww, Gll^Fp, Gll^Fp, Ww, Ww, Ww, Ww, Aa^Fpa, Aa^Fpa, Gll^Fp, Aa^Fpa, Gd, Aa, Ha, Gd, Aa^Vha, Aa^Fpa, Aa^Fpa, Aa^Fpa, Aa^Fpa, Aa^Fpa, Aa^Fpa, Ch, Ch, Ch, Aa^Fpa, Aa^Fpa, Gll^Fp, Gll^Fp
Gd, Aa^Fpa, Aa^Fpa, Gd, Gd, Aa, Aa, Aa, Ai, Ww, Ai, Ai, Ai, Ww, Ww, Ww, Ww, Ww, Ai, Aa, Aa^Fpa, Gll^Fp, Hhd, Hhd, Hhd, Ha, Ha, Aa^Fpa, Aa^Fpa, Aa^Fpa, Aa^Fpa, Gll^Fp, Aa^Fpa, Aa^Vha, Aa^Fpa, Ch, 2 Kh, Ch, Aa^Vha, Ww, Ww, Gd
Gd, Aa^Fpa, Aa^Vha, Aa^Fpa, Gd, Aa, Aa, Aa, Ww, Wo, Ww, Ww, Ww, Wo, Ww, Ww, Aa^Fpa, Aa^Fpa, Aa, Gd, Gll^Fp, Hhd, Mm, Mm, Hhd, Hhd, Ha, Gd, Aa^Fpa, Gd, Aa^Fpa, Aa^Fpa, Ww, Aa^Fpa, Ch, Ch, Ch, Aa^Fpa, Ww, Ww, Ww, Gll^Fp
Aa, Aa^Fpa, Aa^Fpa, Aa^Fpa, Gd, Aa, Aa, Aa, Ai, Ww, Wo, Ww, Wo, Wo, Ww, Aa^Fpa, Aa^Fpa, Aa^Fpa, Aa, Aa^Fpa, Hhd, Mm, Mm, Mm, Mm, Hhd, Gd, Aa, Ww, Ww, Gd, Ww, Aa^Vha, Ww, Aa^Fpa, Aa^Fpa, Re, Ww, Ww, Ww, Ww, Aa^Fpa
Aa, Gd, Aa^Fpa, Aa^Fpa, Aa^Fpa, Gd, Aa, Aa, Ai, Ai, Ai, Wo, Wo, Wo, Ww, Aa^Vha, Aa^Fpa, Aa^Fpa, Aa^Fpa, Hhd, Mm^Vhh, Ww, Ww, Mm, Mm, Mm, Aa^Fpa, Gd, Ai, Ai, Ww, Ww, Aa^Fpa, Ww, Ww^Bw/, Re, Ww, Ww, Ww, Wo, Ai, Aa
Ha, Ha, Ha, Aa, Gd, Aa^Fpa, Gd, Aa, Gd, Aa, Aa, Ai, Wo, Wo, Ww, Ww, Aa^Fpa, Aa^Fpa, Aa, Hhd, Mm, Ww, Ww, Ww, Ww, Ww, Ww, Ww, Ai, Aa, Aa, Ai, Gd, Ww, Aa^Fpa, Ww, Ww, Ww, Ww, Ww, Ai, Aa
Ms, Ms, Ms, Ha, Aa, Aa, Gd, Aa^Fpa, Aa^Vha, Gd, Aa, Gd, Ww, Ww, Ww, Ww, Aa^Fpa, Aa, Aa, Aa^Fpa, Ww, Ww, Ww, Ww, Ww, Ww, Ww, Ww, Aa, Aa, Aa, Aa, Gd, Re, Aa^Fpa, Aa^Fpa, Aa^Fpa, Ww, Ww, Ww, Gd, Gd
Ms, Ms, Ms, Ha, Ha, Aa, Aa, Gd, Aa^Fpa, Aa^Fpa, Gd, Aa^Fpa, Ww, Ww, Gll^Fp, Gll^Fp, Gll^Fp, Aa^Fpa, Aa, Aa^Fpa, Aa^Fpa, Ww, Ww, Ww, Ww, Ww, Aa^Fpa, Gd, Gd, Gd, Aa, Gd, Gd, Re, Aa, Gd, Aa, Aa, Aa, Aa, Aa^Fpa, Aa^Fpa
