Ww, Ww, Ww, Ai, Aa, Ai, Ai, Ww, Gd, Gd, Aa, Ww, Ww, Gd, Gd, Gd, Gd, Aa, Aa, Aa, Aa, Gd, Aa, Aa, Aa, Aa^Fpa, Re, Re, Mm, Mm, Ms, Ms, Ms, Ha, Aa, Aa, Gd, Gd, Gd, Aa^Fpa, Gd, Gd
Aa^Fpa, Gd, Gd, Gd, Aa, Aa, Aa, Gd, Gd, Gd, Ww, Ww, Aa^Fpa, Aa^Fpa, Aa^Fpa, Gll^Fp, Gll^Fp, Aa^Fpa, Gd, Gd, Aa, Aa, Gd, Gd, Gd, Aa^Fpa, Re, Mm, Mm, Mm, Ms, Ms, Ms, Aa, Aa, Aa, Gd, Gd, Gd^Vh, Gd, Gd, Gd
Ww, Ww, Gd, Gd, Aa, Aa, Aa, Gd, Ww, Ww, Aa^Fpa, Aa^Fpa, Aa^Fpa, Aa^Fpa, Gll^Fp, Gd, Gd, Gll^Fp, Aa^Fpa, Aa^Fpa, Gd, Gd, Aa^Fpa, Aa^Fpa, Aa^Fpa, Gll^Fp, Re, Hhd, Mm, Mm, Mm, Ha, Aa, Aa, Aa, Aa, Aa, Gd, Gd, Gd, Gd, Gd
Ww, Gd^Vh, Gd, Gd, Ww, Ai, Ai, Ai, Aa^Fpa, Gll^Fp, Aa^Fpa, Aa^Fpa, Gd, Aa^Fpa, Gll^Fp, Gd, Gd, Gd, Gll^Fp, Aa^Fpa, Gd, Gd, Aa^Fpa, Aa^Fpa, Ch, Ch, Ch, Gd, Gll^Fp, Hhd, Hhd, Gd, Aa, Aa^Vha, Aa, Aa, Gd, Gd, Aa^Fpa, Gd, Gd, Gd
Ww, Ww, Ww, Ww, Ww, Aa, Aa, Gd, Aa^Fpa, Gll^Fp, Aa^Fpa, Aa^Fpa, Gd, Aa^Fpa, Gll^Fp, Gd, Gll^Fp, Gd, Gll^Fp, Aa^Fpa, Aa^Fpa, Gd, Aa^Fpa, Aa^Fpa, Ch, 1 Kh, Ch, Gd, Gll^Fp, Aa^Fpa, Aa^Fpa, Aa, Aa, Aa, Aa, Gd, Gd, Aa^Fpa, Aa^Fpa, Aa^Fpa, Aa^Fpa, Gd
Ai, Ww, Ww, Ww, Gd^Vh, Aa, Aa, Gd, Aa^Fpa, Aa^Fpa, Gd, Gd, Aa, Gd, Aa^Fpa, Aa^Fpa, Aa^Vha, Aa^Fpa, Aa^Fpa, Aa^Fpa, Gd, Gd, Aa^Fpa, Ch, Ch, Ch, Re, Gd^Vh, Gd, Gll^Fp, Aa^Fpa, Aa, Aa, Aa, Gd, Gd, Aa^Fpa, Aa^Fpa, Aa^Fpa, Aa^Fpa, Aa^Fpa, Aa^Fpa
Ai, Ww, Ww, Ww, Ww, Aa, Aa, Aa, Aa, Aa, Aa, Aa, Aa, Aa, Gd, Gd, Gd, Gd, Gd, Gd, Gd, Gd, Gd, Gd, Aa^Fpa, Re, Gll^Fp, Gll^Fp, Gll^Fp, Gll^Fp, Aa^Fpa, Gd, Aa, Aa, Gd, Aa^Fpa, Aa^Fpa, Aa^Fpa, Aa^Fpa, Aa^Fpa, Aa^Fpa, Aa^Fpa
Gd, Ww, Ww, Hhd, Gd, Aa, Aa, Aa, Aa, Aa, Aa, Aa, Aa, Aa, Aa, Aa, Aa, Gd, Aa, Aa, Gd, Aa^Fpa, Aa^Fpa, Aa^Fpa, Re, Re, Aa^Fpa, Aa^Fpa, Aa^Fpa, Aa^Fpa, Aa^Fpa, Gd, Aa, Aa, Gd, Gd, Aa^Fpa, Aa^Fpa, Gll^Fp, Aa^Fpa, Aa^Fpa, Gd
Aa^Fpa, Aa^Fpa, Aa^Fpa, Aa^Fpa, Gd, Aa, Aa^Vha, Aa, Aa, Aa, Aa, Aa, Aa, Aa, Aa, Aa, Aa, Aa, Aa, Gd, Aa^Fpa, Gd, Gd, Gll^Fp, Re, Gd, Gd, Gd, Gd, Aa^Vha, Aa^Fpa, Gd, Gd^Vh, Gd, Aa, Aa, Ww, Ww, Ww, Gd, Gd, Aa
Aa^Fpa, Gll^Fp, Aa^Fpa, Gd, Aa, Aa, Aa, Aa, Aa, Aa, Aa, Aa, Aa, Aa, Aa, Gd, Aa, Gd, Gd, Gd, Aa^Fpa, Gd, Gd^Vh, Re, Gll^Fp, Gd, Gd, Gd, Gd, Hhd, Hhd, Ww, Ww, Ww, Ai, Ai, Ai, Gd^Vh, Gd, Ww, Ww, Ai
Aa^Fpa, Aa^Fpa, Aa^Fpa, Gd, Aa, Aa, Aa, Aa, Aa, Aa, Aa, Aa, Aa, Aa, Gd, Gd, Gd, Gd, Gd, Gd, Aa^Fpa, Gd, Re, Re, Gll^Fp, Aa^Fpa, Gd, Hhd, Mm, Hhd, Mm, Ww, Ww, Ww, Ai, Ai, Ha, Aa, Aa, Gd, Gd, Gd
Aa^Fpa, Aa^Fpa, Aa^Fpa, Aa^Fpa, Aa, Aa, Aa, Aa, Aa, Aa, Aa, Aa, Aa, Gd, Gd, Aa^Fpa, Gd, Gd, Aa, Aa, Aa^Fpa, Re, Gll^Fp, Gd, Gll^Fp, Aa^Fpa, Aa^Fpa, Hhd, Hhd, Mm, Mm, Ww, Ww, Ww, Ai, Ha, Ha, Ha, Aa, Aa, Gd, Gd
Aa^Fpa, Gd, Gd, Gd, Gd, Gd, Gd, Gd, Gd, Aa^Fpa, Aa^Fpa, Aa^Fpa, Gd, Ww, Gd^Vh, Gd, Gd, Gd, Aa, Aa, Aa, Re, Gd, Aa^Fpa, Aa^Fpa, Aa^Fpa, Hhd, Hhd, Mm, Mm, Mm, Mm, Ww, Ww, Ai, Ai, Ha, Aa, Aa, Aa, Aa, Gd
Aa^Fpa, Gd, Aa, Aa, Aa, Aa^Vha, Aa^Fpa, Aa^Fpa, Gll^Fp, Gd, Gd, Aa^Fpa, Ww, Ww, Gd, Gd, Gd, Aa, Aa, Aa, Aa, Re, Aa, Gd, Aa^Vha, Ww, Ww, Hhd, Mm, Mm, Mm, Mm, Ww, Ai, Ha, Ha, Aa, Aa, Aa, Aa, Gd, Gd
Gd, Aa, Aa, Aa, Aa, Gd, Aa^Fpa, Gd, Gd^Vh, Ww, Gd, Gll^Fp, Ww, Ww, Gd, Gd, Aa, Aa, Aa, Aa, Re, Re, Aa, Aa, Ww, Ww, Ww, Ww, Mm, Mm, Mm, Ms, Ms, Ai, Ha, Aa, Aa, Gd, Gd, Gd, Gd, Gd
Gd, Aa, Aa, Aa, Aa, Gd, Aa^Fpa, Gll^Fp, Gd, Gd, Gd, Gll^Fp, Aa^Fpa, Gd, Aa, Aa, Aa, Aa, Aa, Aa, Re, Aa, Aa, Aa, Ww, Ww, Ww, Ww, Ww, Ww, Ms, Ms, Ms, Ms, Gd, Gd, Aa^Fpa, Aa^Fpa, Aa^Vha, Gd, Gd, Gd
Gd, Gd, Gd, Aa, Aa, Aa^Fpa, Aa^Fpa, Aa^Fpa, Gll^Fp, Gd, Gd, Gll^Fp, Aa^Fpa, Aa^Fpa, Gd, Gd, Aa, Aa, Aa, Aa, Re, Aa, Aa, Aa, Aa, Ww, Ww, Mm^Vhh, Mm, Ww, Ms, Ms, Ms, Ha, Aa^Fpa, Gll^Fp, Gll^Fp, Aa^Fpa, Aa^Fpa, Aa^Fpa, Gd, Gd
Gd, Gd, Aa^Fpa, Aa^Fpa, Gd, Aa^Fpa, Aa^Fpa, Gd, Aa^Fpa, Gll^Fp, Aa^Fpa, Aa^Fpa, Aa^Fpa, Aa^Fpa, Aa^Fpa, Gd, Aa, Aa, Aa, Aa, Re, Ha, Aa, Aa, Aa, Ai, Ww, Ms, Ms, Ms, Ms, Mm, Hhd, Hhd, Gll^Fp, Gll^Fp, Gll^Fp, Gll^Fp, Aa^Fpa, Gd, Gd, Aa
Aa^Fpa, Ww, Aa^Fpa, Aa^Fpa, Aa^Fpa, Gd, Aa, Aa, Aa, Gd, Gd, Gd, Aa^Fpa, Gll^Fp, Aa^Fpa, Aa^Fpa, Gd, Aa, Re, Re, Ha, Ha, Ha, Aa, Aa, Aa, Ai, Ha, Ms, Ms, Ms, Hhd, Gll^Fp, Gll^Fp, Gd, Gll^Fp, Aa^Fpa, Aa^Fpa, Gd, Ai, Ai, Ww
Ww, Ww, Aa^Fpa, Aa^Fpa, Gd, Gd, Aa, Aa, Aa, Aa, Aa, Aa, Gll^Fp, Gll^Fp, Gll^Fp, Aa^Fpa, Gd, Aa, Re, Aa, Aa, Ha, Aa, Aa, Aa, Aa, Ai, Aa, Aa, Aa, Gd, Aa^Fpa, Gll^Fp, Gd^Vh, Gd, Gll^Fp, Gd, Gd, Aa, Aa, Aa, Ai
Aa^Fpa, Ww, Gd^Vh, Gd, Aa, Aa, Aa, Aa, Aa, Aa, Aa, Gd, Aa^Fpa, Gll^Fp, Gll^Fp, Aa^Fpa, Aa^Fpa, Gd, Re, Aa, Aa, Aa, Aa, Aa, Aa, Aa, Aa, Ai, Aa, Gd, Aa^Fpa, Gll^Fp, Gd, Gd, Gd, Gll^Fp, Aa^Fpa, Aa^Fpa, Aa, Aa, Aa, Aa
Ww, Gd, Aa, Aa, Aa, Aa, Aa, Aa, Aa, Aa, Aa, Aa^Fpa, Gll^Fp, Gll^Fp, Ww, Aa^Vha, Aa^Fpa, Re, Gd^Vh, Aa, Aa, Aa, Aa, Aa, Aa, Aa, Aa, Ai, Ai, Ww, Ww, Ww, Ww, Ww, Ww, Gll^Fp, Aa^Fpa, Aa^Fpa, Aa, Aa, Aa, Aa
Gd, Aa, Aa, Aa, Aa, Aa, Aa, Aa, Gd, Gd, Aa^Fpa, Aa^Fpa, Gll^Fp, Aa^Fpa, Ww, Aa^Fpa, Re, Re, Aa, Aa, Aa, Aa, Aa, Aa, Aa, Aa, Aa, Ai, Aa, Gd, Aa^Fpa, Aa^Fpa, Gll^Fp, Gd^Vh, Ww, Gd, Gll^Fp, Aa^Fpa, Gd, Aa, Aa, Aa
Aa, Aa, Aa, Aa, Aa, Aa, Aa, Gd, Aa^Fpa, Aa^Fpa, Aa^Fpa, Gll^Fp, Gll^Fp, Aa^Fpa, Re, Re, Gd, Gd, Aa, Aa, Aa, Aa, Aa, Aa, Aa, Aa, Aa, Aa, Aa, Gd, Aa^Fpa, Aa^Fpa, Gll^Fp, Gd, Gd, Ww, Gll^Fp, Aa^Fpa, Aa^Fpa, Aa, Aa, Aa
Gd, Aa, Aa, Aa, Aa, Aa, Gd, Aa^Fpa, Aa^Vha, Gll^Fp, Aa^Fpa, Aa^Fpa, Aa^Fpa, Gd, Re, Aa^Fpa, Aa^Fpa, Aa, Aa, Aa, Aa, Aa, Aa, Aa, Aa, Aa, Aa, Aa, Gd, Aa^Fpa, Aa^Vha, Aa^Fpa, Aa^Fpa, Aa^Fpa, Gd, Ww, Gd, Gll^Fp, Aa^Fpa, Gd, Ha, Ai
Gd, Aa, Aa, Aa, Aa, Aa, Gd, Aa^Fpa, Aa^Fpa, Aa^Fpa, Gll^Fp, Aa^Fpa, Re, Re, Aa^Fpa, Aa^Fpa, Aa^Fpa, Aa, Aa, Aa, Aa, Aa, Aa, Aa, Aa, Aa, Aa, Ha, Ha, Aa^Fpa, Aa^Fpa, Aa^Fpa, Gd, Aa^Fpa, Gll^Fp, Ww, Gd, Gll^Fp, Aa^Fpa, Gd^Vh, Ww, Ww
Aa^Fpa, Gd, Aa, Aa, Aa, Aa, Gd, Gd, Aa^Fpa, Gll^Fp, Gll^Fp, Re, Gll^Fp, Aa^Fpa, Aa^Fpa, Aa^Vha, Aa^Fpa, Gd, Gd, Gd, Gd, Gd, Aa, Aa, Ha, Ha, Ha, Ms, Mm, Aa^Fpa, Aa^Fpa, Gd, Gd, Aa^Fpa, Aa^Fpa, Ww, Gll^Fp, Gll^Fp, Aa^Fpa, Hhd, Ww, Ww
Ww, Gd^Vh, Aa, Aa, Aa, Aa, Aa, Gd, Aa^Fpa, Aa^Fpa, Gd, Re, Gd, Gd, Aa^Fpa, Aa^Fpa, Aa^Fpa, Aa^Fpa, Gd, Gd, Aa^Fpa, Gd, Gd, Ha, Ms, Ms, Ms, Ms, Mm, Hhd, Gd, Gd, Aa^Fpa, Aa^Fpa, Ww, Ww, Aa^Fpa, Aa^Fpa, Aa^Fpa, Gd, Ha, Ww
Gd, Ai, Aa, Aa, Aa, Aa, Aa, Aa, Gd, Aa^Fpa, Gll^Fp, Re, Gd, Gll^Fp, Gll^Fp, Aa^Fpa, Aa^Fpa, Aa^Fpa, Gd, Aa^Fpa, Gd, Aa^Fpa, Aa, Ms, Ms, Ms, Ms, Ms, Ms, Ha, Gd, Gd, Gd, Aa^Vha, Ww, Ww, Aa^Fpa, Aa^Fpa, Aa^Fpa, Gd, Aa, Aa
Ai, Ai, Aa, Aa, Aa, Aa, Aa, Aa, Aa, Aa^Fpa, Gll^Fp, Re, Re, Gd, Gll^Fp, Gll^Fp, Aa^Fpa, Aa^Fpa, Aa^Fpa, Aa^Vha, Gd, Gd, Aa, Ha, Ms, Ms, Ms, Ms, Ms, Ha, Gd, Aa, Gd, Aa^Fpa, Aa^Fpa, Ww, Ww, Aa^Fpa, Aa^Fpa, Gd, Aa, Aa
Ai, Aa, Aa, Aa, Aa, Aa, Aa, Aa, Gd, Aa^Fpa, Aa^Fpa, Gll^Fp, Re, Gll^Fp, Gll^Fp, Aa^Fpa, Aa^Fpa, Aa^Fpa, Aa^Fpa, Aa^Fpa, Gd, Gd, Aa, Ha, Ms, Ms, Ms, Ms, Ms, Gd, Gd, Gd, Gd, Gd, Gd, Aa^Fpa, Ww, Ww, Aa^Fpa, Gd, Gd, Aa
Ai, Aa, Aa, Aa, Aa, Aa, Aa, Aa, Gd, Gd, Aa^Fpa, Aa^Vha, Re, Gll^Fp, Aa^Fpa, Aa^Fpa, Aa^Fpa, Gd, Aa^Fpa, Gd, Gd, Aa, Gd, Ha, Ms, Ms, Ms, Ms, Hhd, Gd, Gd, Gd, Re, Gd, Gd, Ww, Ww, Ww, Gd^Vh, Gd, Gd, Gd
Ai, Aa, Aa, Aa, Aa, Aa, Ai, Aa, Aa, Gd, Gd, Aa^Fpa, Re, Aa^Fpa, Aa^Vha, Aa^Fpa, Gd, Gd, Aa, Aa, Aa, Aa, Gd, Hhd, Ha, Ha, Ha, Ha, Gd, Aa^Fpa, Re, Re, Aa^Fpa, Re, Re, Gd, Ww, Ww, Gd, Gd, Gd, Gd
Ai, Ai, Ha, Aa, Gd^Vh, Aa, Ai, Ai, Aa, Gd, Aa^Fpa, Aa^Fpa, Gll^Fp, Re, Re, Aa^Fpa, Gd, Aa, Aa, Aa, Aa, Aa, Gd, Ha, Ha, Ha, Aa, Aa, Gd^Vh, Re, Gd, Aa^Fpa, Aa^Fpa, Aa^Fpa, Aa^Fpa, Re, Re, Re, Re, Aa, Aa, Aa
Ai, Ai, Ms, Ww, Ha, Ai, Aa, Ai, Gd, Aa^Fpa, Aa^Fpa, Gll^Fp, Gll^Fp, Re, Gll^Fp, Re, Re, Aa, Re, Aa^Vha, Re, Aa, Aa, Ha, Ha, Aa, Aa, Aa, Re, Re, Gd, Aa^Fpa, Aa^Vha, Aa^Fpa, Aa^Fpa, Gd, Aa, Aa, Aa^Vha, Re, Re, Aa
Ww, Ww, Ww, Ai, Ai, Ai, Aa, Ai, Gd, Aa^Fpa, Ch, Ch, Ch, Re, Aa^Fpa, Aa^Fpa, Aa, Re, Aa, Re, Aa, Re, Re, Ha, Re, Re, Re, Re, Aa, Aa, Gd, Aa^Fpa, Aa^Fpa, Aa^Fpa, Aa^Fpa, Gd, Aa, Aa, Aa, Aa, Aa, Re
Ww, Ww, Ww, Ai, Ai, Ai, Aa, Ai, Ai, Aa^Fpa, Ch, 2 Kh, Ch, Gd, Aa, Aa, Aa, Aa, Aa, Aa, Aa, Aa, Aa, Re, Aa, Aa^Vha, Aa, Aa, Aa, Gd, Aa^Fpa, Aa^Fpa, Aa^Fpa, Aa^Fpa, Aa^Fpa, Aa, Aa, Aa, Aa, Aa, Aa, Aa
Ww, Ww, Ww, Ai, Ai, Ai, Ai, Aa, Aa, Ch, Ch, Ch, Gd^Vh, Gd, Aa, Aa, Aa, Aa, Aa, Aa, Aa, Aa, Aa, Aa, Aa, Gd, Gd, Gd, Gd, Gd, Aa^Fpa, Aa^Fpa, Gll^Fp, Aa^Fpa, Gd, Aa, Aa, Aa, Aa, Aa, Aa, Aa
Mm, Ww, Ww, Ww, Ai, Ai, Aa, Aa, Aa, Ww, Ai, Ww, Gd, Gd, Gd, Gd, Aa, Aa, Aa, Aa, Aa, Aa, Ha, Ha, Gd, Gd, Gd, Gd, Aa, Gd, Aa^Fpa, Gll^Fp, Gll^Fp, Aa^Fpa, Gd, Aa, Aa, Gd, Gd, Gd, Aa, Aa
Mm, Hhd, Hhd, Ww, Ai, Ai, Aa, Aa, Aa, Aa, Aa, Ai, Aa, Aa, Gd, Gd, Gd, Aa, Aa, Aa, Aa, Aa, Ha, Ha, Gd, Gd, Gd, Aa, Aa, Gd, Aa^Fpa, Aa^Fpa, Gll^Fp, Gll^Fp, Aa^Fpa, Aa, Aa, Aa, Aa^Fpa, Gd, Aa, Aa
Gd, Hhd, Hhd^Vhh, Ww, Hhd, Ww, Gd, Aa, Aa, Aa, Aa, Ai, Aa, Aa, Aa, Gd, Aa, Aa, Aa, Aa, Aa, Aa, Aa, Aa, Aa, Aa, Gd, Aa, Aa, Gd, Aa^Fpa, Aa^Fpa, Aa^Fpa, Gll^Fp, Aa^Fpa, Gd, Aa, Aa, Gd, Gd, Aa, Aa
Gd, Hhd, Hhd, Hhd, Gll^Fp, Aa^Fpa, Gd, Aa, Aa, Aa, Aa, Ai, Ai, Ai, Ww, Gd, Aa^Fpa, Gd, Gd, Aa, Aa, Aa, Aa, Aa, Aa, Aa, Aa, Gd, Aa, Aa, Gd, Aa^Fpa, Aa^Fpa, Aa^Fpa, Aa^Fpa, Aa, Aa, Aa, Aa, Aa, Aa, Aa
