Aa, Aa, Aa, Aa, Aa, Aa, Aa^Fpa, Aa^Fpa, Re, Aa, Aa, Aa, Aa, Aa, Aa, Aa, Aa, Gd, Aa^Fpa, Aa^Fpa, Aa^Fpa, Gd, Aa, Aa, Gd, Aa, Aa, Aa, Aa, Aa, Ha, Ha, Ha, Ha, Ms, Ha, Ms, Mm, Ha, Ha, Ha, Aa^Fpa
Aa, Aa, Aa, Aa, Aa, Aa, Gd, Gd, Gd, Re, Re, Aa, Aa, Aa, Aa, Aa, Aa, Gd, Gd, Aa^Fpa, Aa^Fpa, Ha, Aa, Gd, Aa^Fpa, Aa^Fpa, Gd, Aa, Aa, Aa, Ha, Ms, Ms, Ha, Ha, Ha, Mm, Mm, Mm, Mm, Hhd, Hhd
Aa, Aa, Aa, Aa, Aa, Aa, Aa, Aa, Aa, Aa, Aa, Re, Re, Aa, Aa, Aa, Aa, Gd, Gd, Gd, Gd, Aa, Gd, Aa^Fpa, Aa^Fpa, Aa^Fpa, Aa^Fpa, Aa^Fpa, Gd, Aa, Gd, Hhd, Hhd, Hhd, Hhd, Ha, Ha, Mm, Mm, Mm, Mm, Ms
Aa, Aa, Aa, Aa, Aa, Aa, Aa, Aa, Aa, Ww, Gd, Aa^Fpa, Aa^Fpa, Re, Re, Aa, Aa, Aa^Fpa, Aa^Fpa, Gd, Gd, Gd, Aa^Fpa, Aa^Fpa, Gll^Fp, Aa^Fpa, Aa^Fpa, Aa^Fpa, Aa^Fpa, Aa, Aa^Fpa, Aa^Vha, Gll^Fp, Gd, Ch, Ch, Ch, Ms, Hhd^Vhh, Mm, Mm, Hhd
Aa, Aa, Aa, Aa, Aa, Aa, Gd, Aa^Fpa, Aa^Fpa, Aa^Fpa, Aa^Fpa, Aa^Fpa, Aa^Fpa, Gd, Re, Aa, Aa, Aa^Fpa, Aa^Fpa, Aa^Fpa, Gd, Gd, Aa^Fpa, Gll^Fp, Hhd, Aa^Fpa, Hhd, Hhd, Ha, Ha, Aa^Fpa, Aa^Fpa, Gll^Fp, Gd, Ch, 1 Kh, Ch, Gd, Hhd, Hhd, Hhd, Aa^Fpa
Aa, Aa^Vha, Aa, Aa, Aa, Gd, Gd, Aa^Fpa, Aa^Fpa, Aa^Vha, Aa^Fpa, Aa^Fpa, Aa^Fpa, Gd, Re, Aa, Aa, Aa^Fpa, Aa^Fpa, Aa^Fpa, Aa^Fpa, Gd, Aa^Fpa, Aa^Fpa, Hhd, Hhd, Ha, Ms, Ms, Ms, Hhd, Aa^Fpa, Aa^Vha, Ch, Ch, Ch, Aa^Fpa, Re, Aa^Fpa, Aa^Fpa, Aa^Fpa, Aa^Fpa
Aa, Aa, Aa, Aa, Aa, Aa, Gd, Aa, Gd, Aa^Fpa, Gd, Aa^Fpa, Aa^Fpa, Aa^Vha, Re, Aa, Aa, Aa^Fpa, Aa^Fpa, Aa^Vha, Aa^Fpa, Hhd, Aa^Fpa, Aa^Fpa, Aa^Fpa, Hhd, Ms, Ms, Ms, Ms, Hhd, Aa^Fpa, Aa^Fpa, Aa^Fpa, Aa^Fpa, Aa^Fpa, Re, Re, Gd, Aa^Fpa, Aa^Fpa, Aa^Fpa
Hhd, Ms, Ha, Hhd, Ha, Aa, Aa, Aa, Aa, Aa, Aa, Aa, Gd, Gd, Gd, Re, Gd, Gd, Aa^Fpa, Aa^Fpa, Aa^Fpa, Aa^Fpa, Aa^Fpa, Aa^Fpa, Aa^Fpa, Aa^Fpa, Ms, Ms, Ms, Ms, Ha, Aa, Gd, Gd, Aa^Fpa, Aa, Re, Aa, Gd, Aa^Fpa, Aa^Fpa, Gll^Fp
Mm, Mm, Mm, Ms, Ha, Ha, Ha, Aa, Aa, Aa, Aa, Aa, Aa, Gd, Gd, Re, Gd, Gd, Gd, Gd, Gd, Aa^Fpa, Gd, Gd, Aa^Fpa, Aa^Fpa, Ha, Ms, Ms, Ha, Ha, Aa, Gd, Aa, Aa, Aa, Re, Aa, Gd, Aa^Fpa, Aa^Vha, Gll^Fp
Mm, Mm, Ms, Ms, Ha, Ha, Ha, Ha, Aa, Aa, Aa, Aa, Gd, Aa, Aa, Re, Gd, Gd, Gd, Aa, Aa^Fpa, Aa^Fpa, Aa^Fpa, Aa^Fpa, Aa^Fpa, Aa^Fpa, Aa^Fpa, Ha, Ha^Vhha, Ha, Aa, Ha, Gd, Gd, Re, Re, Aa^Fpa, Gd, Gd, Gd, Aa^Fpa, Gll^Fp
Mm, Ha, Ms, Ms, Ha, Aa, Ha, Ha, Aa^Fpa, Aa^Fpa, Aa^Fpa, Gd, Aa^Fpa, Gd, Aa, Re, Aa, Aa, Gd, Aa^Fpa, Aa^Fpa, Aa^Fpa, Aa^Fpa, Aa^Fpa, Aa^Fpa, Aa^Fpa, Aa^Fpa, Ha, Ha, Ha, Ha, Ha, Aa, Re, Aa^Fpa, Aa^Fpa, Aa^Fpa, Gd, Gd, Aa, Aa^Fpa, Aa^Fpa
Ha, Ms, Ms, Ha, Ha, Aa, Aa, Gd, Aa^Vha, Aa^Fpa, Aa^Fpa, Aa^Fpa, Gd, Aa, Aa, Re, Re, Aa, Gd, Aa, Gd, Aa^Fpa, Aa^Fpa, Aa^Fpa, Aa^Fpa, Aa^Vha, Aa^Fpa, Aa, Ha, Ha, Ha, Aa, Re, Re, Aa^Fpa, Aa^Fpa, Gd, Gd, Aa, Aa, Aa, Gd
Ha, Ms, Ms, Ha, Ha, Aa, Aa, Aa^Fpa, Aa^Fpa, Aa^Fpa, Gll^Fp, Aa^Fpa, Aa^Fpa, Aa, Aa, Aa, Re, Aa, Aa, Aa, Aa, Aa, Aa^Fpa, Gd, Aa^Fpa, Gd, Aa, Aa, Aa, Ha, Ha, Re, Aa, Aa, Aa, Aa, Aa, Aa, Aa, Aa, Aa, Aa^Fpa
Aa, Aa, Ha, Ha, Ha, Aa, Aa^Fpa, Aa^Fpa, Aa^Fpa, Gll^Fp, Gll^Fp, Gll^Fp, Aa^Fpa, Aa^Fpa, Aa^Fpa, Aa^Fpa, Re, Aa, Aa, Aa, Aa, Aa, Ai, Aa, Aa, Aa, Aa, Aa, Aa, Ha, Ha^Vhha, Re, Aa, Aa, Aa, Aa, Gd, Gd, Aa, Aa, Aa, Gd
Aa, Aa, Ha, Ms, Ha, Gd, Aa^Fpa, Gll^Fp, Gll^Fp, Gll^Fp, Gd, Gd, Gd, Aa^Fpa, Aa^Fpa, Aa^Vha, Re, Aa, Aa, Ai, Ai, Ai, Ww, Ww, Gd^Vh, Aa^Fpa, Aa^Fpa, Aa^Fpa, Ha, Ha, Re, Re, Aa, Aa, Aa, Aa, Gd, Aa, Aa, Aa, Aa, Gd
Aa, Aa, Ha, Ha, Hhd, Aa^Vha, Gll^Fp, Aa^Fpa, Gll^Fp, Gll^Fp, Gd, Gd, Gll^Fp, Aa^Fpa, Aa^Fpa, Aa^Fpa, Re, Aa, Ai, Ai, Ww, Wo, Wo, Ww, Aa^Fpa, Aa^Fpa, Gll^Fp, Aa^Fpa, Re, Re, Aa, Aa, Aa, Aa, Aa, Aa, Aa, Aa, Aa, Aa, Aa, Aa
Gd, Aa^Fpa, Aa^Fpa, Hhd, Hhd, Hhd, Gll^Fp, Gd, Gll^Fp, Gd, Gd, Gll^Fp, Gll^Fp, Aa^Fpa, Aa^Fpa, Aa^Fpa, Aa, Re, Ai, Ww, Ww, Ww, Ww, Ww, Aa^Fpa, Aa^Fpa, Aa^Fpa, Re, Hhd, Ha, Ha, Ha, Aa, Aa, Aa, Gd, Aa, Aa, Aa, Aa, Aa, Aa
Aa^Fpa, Aa^Fpa, Hhd, Hhd, Hhd, Mm, Hhd, Hhd, Gd, Gd, Gd, Gd, Aa^Fpa, Aa^Fpa, Aa^Fpa, Aa^Fpa, Aa^Fpa, Re, Re, Aa^Fpa, Ww, Aa^Fpa, Ww, Aa^Fpa, Aa^Fpa, Aa^Fpa, Aa^Vha, Re, Ha, Ms, Ms, Ms, Ms, Hhd, Gd, Aa^Fpa, Gd, Aa, Aa, Aa, Aa, Aa
Gd, Aa^Fpa, Aa^Fpa, Hhd, Hhd, Mm, Hhd, Hhd, Mm, Hhd, Hhd, Gll^Fp, Aa^Fpa, Aa^Vha, Aa^Fpa, Aa^Fpa, Aa^Fpa, Aa^Fpa, Gd, Re, Re, Gd, Gd, Aa^Fpa, Gd, Aa^Fpa, Aa^Fpa, Re, Ha, Ms, Ai, Ai, Ai, Ms, Gd, Gd, Aa^Fpa, Aa^Fpa, Ai, Ai, Ww, Ww
Aa^Fpa, Aa^Fpa, Aa^Fpa, Hhd, Hhd, Mm, Mm, Mm, Mm, Mm, Mm, Hhd, Aa^Vha, Aa^Fpa, Aa^Fpa, Aa^Fpa, Gd, Gd, Aa, Aa, Aa, Re, Re, Aa, Aa, Gd, Re, Re, Ha, Ms, Ai, Ai, Ai, Mm, Ww, Aa^Fpa, Ww, Ww, Ww, Gd, Aa^Fpa, Aa^Fpa
Aa^Fpa, Aa^Vha, Aa^Fpa, Hhd, Hhd, Ms, Mm, Mm, Ms, Ms, Ms, Ha, Aa^Fpa, Gll^Fp, Gll^Fp, Aa^Fpa, Aa^Fpa, Gd, Gd, Aa, Aa, Aa, Aa^Vha, Re, Re, Re, Gd, Aa, Ha, Ai, Ai, Ai, Ww, Ww, Ww, Ha^Vhha, Ww, Aa^Fpa, Aa^Fpa, Aa^Fpa, Aa^Fpa, Aa^Fpa
Aa^Fpa, Aa^Fpa, Aa^Fpa, Aa^Fpa, Hhd, Mm, Ms, Ms, Ms, Ms, Ms, Ha, Hhd, Aa^Fpa, Gll^Fp, Gll^Fp, Aa^Fpa, Gd, Gd, Aa^Fpa, Gd, Aa, Aa, Re, Aa, Aa, Gd, Gd, Ms, Ai, Ai, Ai, Ww, Ww, Ww, Ha, Ww, Aa^Fpa, Aa^Fpa, Aa^Fpa, Gd, Ha
Aa^Fpa, Aa^Fpa, Aa^Fpa, Aa^Fpa, Aa^Fpa, Ms, Ms, Ms, Ms, Ms, Ms, Ha, Aa^Fpa, Aa^Fpa, Aa^Fpa, Aa^Fpa, Aa^Fpa, Gd, Gd, Gd, Aa, Aa, Re, Re, Aa, Aa^Fpa, Aa^Fpa, Aa^Fpa, Mm, Mm, Ww, Ww, Ww, Ww, Ai, Ai, Gd, Gd, Aa^Vha, Aa^Fpa, Aa^Fpa, Ms
Aa^Fpa, Gll^Fp, Gll^Fp, Aa^Fpa, Aa^Fpa, Hhd, Ha, Ha, Ha, Aa, Ha, Ha, Ha, Gd, Gd, Gd, Aa^Fpa, Gd, Aa, Aa, Re, Re, Aa, Aa, Aa, Aa^Fpa, Aa^Fpa, Hhd, Mm, Mm, Mm, Ww, Mm, Ww, Ms, Aa, Gd, Gd, Aa^Fpa, Gd, Ha, Ms
Aa^Fpa, Gd, Gll^Fp, Aa^Fpa, Aa^Fpa, Aa^Fpa, Aa^Fpa, Gd, Aa, Gd, Re, Re, Re, Re, Re, Re, Re, Aa, Re, Re, Aa, Aa, Aa, Aa, Aa, Aa^Fpa, Hhd, Mm, Mm, Mm, Ms, Ms, Ms, Ms, Aa, Aa, Aa, Aa^Fpa, Gd, Hhd, Ms, Ms
Gll^Fp, Gll^Fp, Gll^Fp, Aa^Fpa, Aa^Fpa, Aa^Fpa, Aa^Fpa, Aa^Fpa, Aa^Fpa, Re, Aa^Fpa, Aa, Aa, Aa, Aa, Aa, Aa, Re, Aa, Gd, Aa, Aa, Aa, Aa^Fpa, Aa^Fpa, Aa^Fpa, Hhd, Hhd, Hhd, Hhd, Ha, Ha, Aa, Aa, Aa, Aa, Aa, Aa, Aa, Ha, Ms, Ms
Aa^Fpa, Aa^Fpa, Aa^Fpa, Aa^Fpa, Aa^Vha, Aa^Fpa, Gll^Fp, Gll^Fp, Gll^Fp, Re, Aa^Fpa, Aa, Aa, Aa, Aa, Aa, Aa, Re, Re, Gd, Aa^Fpa, Aa^Fpa, Aa^Fpa, Aa^Fpa, Aa^Vha, Hhd, Hhd, Hhd, Mm, Mm, Ha, Aa, Aa, Gd, Aa, Aa, Aa, Aa, Aa, Ha, Ms, Ms
Aa^Fpa, Aa^Fpa, Gd, Gd, Aa^Fpa, Aa^Fpa, Gll^Fp, Gll^Fp, Re, Re, Aa^Fpa, Aa^Fpa, Aa, Aa, Aa, Aa, Aa, Gd, Re, Aa^Fpa, Aa^Fpa, Aa^Vha, Aa^Fpa, Gll^Fp, Gll^Fp, Hhd, Mm, Mm, Mm, Hhd, Aa^Fpa, Aa^Fpa, Aa, Gd, Aa^Fpa, Aa, Aa, Aa, Aa, Ha, Ms, Ms
Aa, Aa, Aa, Aa, Gd, Aa^Fpa, Aa^Fpa, Gll^Fp, Re, Gll^Fp, Gll^Fp, Aa^Fpa, Aa^Fpa, Aa, Aa, Ai, Ai, Aa^Fpa, Aa^Vha, Re, Aa^Fpa, Aa^Fpa, Gll^Fp, Gll^Fp, Gll^Fp, Hhd, Mm, Mm, Mm, Mm, Aa^Fpa, Aa^Vha, Gd, Aa^Fpa, Gd, Aa^Fpa, Aa, Aa, Aa, Ha, Ha, Ha
Aa, Aa, Aa, Aa, Aa, Ha, Aa^Fpa, Aa^Fpa, Re, Gll^Fp, Aa^Fpa, Ww, Ww, Ai, Ai, Ai, Ai, Gd, Aa^Fpa, Re, Aa^Fpa, Aa^Fpa, Gll^Fp, Gll^Fp, Hhd, Mm, Mm, Mm, Mm, Mm, Gll^Fp, Aa^Fpa, Gd, Gd, Aa^Fpa, Gd, Aa, Aa^Fpa, Aa^Fpa, Hhd, Aa, Aa
Aa, Aa, Aa, Aa, Aa, Aa, Re, Re, Aa^Fpa, Aa^Fpa, Aa^Vha, Ww, Ww, Ww, Ww, Ww, Ai, Aa, Gd, Re, Aa^Fpa, Hhd, Hhd, Hhd, Hhd, Hhd, Mm, Mm, Mm, Mm, Gd, Aa^Fpa, Aa^Fpa, Aa^Fpa, Gd, Gd, Aa, Aa^Fpa, Aa^Vha, Aa^Fpa, Aa, Aa
Aa, Aa, Aa, Aa, Aa, Aa, Re, Aa, Gd, Aa^Fpa, Aa^Fpa, Ww, Wo, Wo, Wo, Wo, Ww, Ai, Aa, Re, Aa^Fpa, Hhd, Mm, Mm, Hhd, Hhd, Mm, Mm, Hhd, Hhd, Gd, Gll^Fp, Aa^Fpa, Gd, Aa, Aa, Aa, Aa^Fpa, Aa^Fpa, Aa^Fpa, Gd, Aa
Ai, Aa, Aa, Aa, Aa, Aa^Vha, Re, Aa^Fpa, Aa^Fpa, Aa^Fpa, Gd, Ai, Wo, Wo, Wo, Wo, Ww, Ai, Aa, Re, Aa^Fpa, Hhd, Mm, Mm, Hhd, Gll^Fp, Gll^Fp, Gd, Gd, Gll^Fp, Gll^Fp, Aa^Fpa, Aa^Fpa, Gd, Aa, Aa, Aa, Gd, Gd, Gd, Aa, Aa
Ai, Ai, Aa, Aa, Aa, Aa, Re, Ch, Ch, Ch, Gd, Ai, Wo, Wo, Wo, Wo, Ai, Ai, Aa, Re, Aa^Fpa, Hhd, Hhd, Hhd, Aa^Fpa, Gll^Fp, Gll^Fp, Gll^Fp, Gd, Gll^Fp, Aa^Fpa, Aa^Fpa, Aa^Fpa, Aa, Aa, Aa, Aa, Aa, Aa, Aa, Aa, Aa
Ai, Ai, Aa, Aa, Aa, Aa, Aa^Fpa, Ch, 2 Kh, Ch, Aa, Ai, Ai, Ww, Ai, Ai, Aa^Vha, Aa, Aa, Re, Re, Aa^Fpa, Hhd, Aa^Fpa, Aa^Fpa, Gll^Fp, Gd^Vh, Gd, Gll^Fp, Gll^Fp, Aa^Fpa, Aa^Vha, Aa, Aa, Aa, Aa, Ha, Aa, Aa, Aa, Aa, Aa
Aa, Aa, Aa, Aa, Aa, Aa, Ch, Ch, Ch, Aa^Fpa, Gd, Aa, Ai, Ai, Ai, Aa, Aa, Aa, Aa, Aa, Re, Aa^Fpa, Aa^Fpa, Aa^Vha, Aa^Fpa, Gll^Fp, Gd, Gd, Gd, Gd, Gd, Aa^Fpa, Gd, Aa, Aa, Aa, Aa, Aa, Aa, Aa, Aa, Aa
Ai, Ai, Aa, Aa, Ha, Aa, Aa, Aa, Aa, Gd, Aa^Vha, Aa, Aa, Ww, Gd, Aa, Aa, Aa, Aa, Aa, Aa^Fpa, Re, Re, Aa^Fpa, Gd, Aa^Fpa, Gd, Gd, Gd, Gd, Gd, Aa^Fpa, Gd, Aa, Aa, Aa, Aa, Aa, Aa, Aa, Aa, Aa
Ww, Ha, Ha, Ha, Ms, Ms, Ms, Ha, Aa, Aa, Gd, Gd, Aa^Fpa, Ww, Gd, Gd, Aa, Aa, Aa, Aa, Aa^Fpa, Aa^Fpa, Gd, Re, Re, Aa^Fpa, Gll^Fp, Gd, Gd, Gd, Gd, Aa^Fpa, Gd, Aa, Aa, Aa, Aa, Gd, Aa, Aa, Aa, Aa
Ww, Mm, Mm, Ms, Ms, Ms, Ms, Ms, Aa, Aa, Ww, Aa^Fpa, Ww, Ww, Aa^Fpa, Gd, Aa, Aa, Ha, Ha, Gd, Gd, Aa, Gd, Re, Gd, Gll^Fp, Gd, Gd, Gd, Gll^Fp, Aa^Fpa, Aa, Aa, Aa, Aa, Gd, Aa^Fpa, Aa^Vha, Aa^Fpa, Aa^Fpa, Aa^Fpa
Ww, Ww, Mm, Mm, Ms, Ms, Ms, Ms, Ha, Ww, Ww, Ww, Ww, Aa^Fpa, Aa^Fpa, Gd, Aa, Ha, Ha, Ms, Ha, Ha, Aa, Ha, Ms, Re, Re, Hhd, Gd, Gll^Fp, Aa^Fpa, Gd, Aa, Aa, Aa, Aa, Aa, Aa^Fpa, Gll^Fp, Gll^Fp, Gll^Fp, Gll^Fp
Ww, Mm^Vhh, Mm, Mm, Mm, Ms, Ms, Ai, Ai, Ww, Ww, Ww, Ww, Aa^Vha, Aa^Fpa, Aa, Aa, Ha, Ms, Ms, Ms, Ms, Ha, Ha, Ms, Ms, Ms, Re, Re, Aa^Fpa, Aa^Fpa, Aa, Aa, Ai, Ai, Ai, Aa, Aa^Fpa, Gll^Fp, Gd, Gd, Gd
Ww, Mm, Mm, Hhd, Ms, Ms, Ms, Ha, Ha, Ww, Ww, Ww, Ww, Ww, Gd, Aa, Ha, Ms, Ms, Ms, Ms, Ms, Ms, Ms, Ms, Ms, Ms, Ms, Hhd, Re, Aa^Fpa, Aa, Aa, Ww, Ww, Ai, Gd, Aa^Fpa, Aa^Fpa, Gd, Gd, Gd
