Aa^Fpa, Aa^Fpa, Aa^Fpa, Aa^Fpa, Gd, Ha, Hhd, Aa^Fpa, Gd, Aa, Aa, Aa, Aa, Aa, Re, Re, Re, Gll^Fp, Gd, Gd, Gd, Gd, Gd, Gd, Gd, Re, Re, Re, Aa^Fpa, Gd, Ai, Aa, Ai, Ai, Ai, Ai, Ha, Ms, Mm, Mm, Mm, Ai
Aa^Fpa, Aa^Vha, Aa^Fpa, Aa^Fpa, Aa^Fpa, Ha, Hhd, Aa^Fpa, Aa^Vha, Gd, Re, Aa, Re, Re, Aa^Fpa, Aa^Fpa, Aa^Fpa, Gll^Fp, Gd, Gd, Gd, Gd, Gd, Gll^Fp, Gll^Fp, Ww, Ww, Aa^Fpa, Ww, Ww, Ai, Ai, Ai, Ai, Ai, Ai, Ms, Ms, Ms, Ms, Mm, Ww
Aa^Fpa, Aa^Fpa, Aa^Fpa, Aa^Fpa, Aa^Fpa, Ha, Aa^Fpa, Aa^Fpa, Re, Re, Aa, Re, Aa, Aa, Aa^Fpa, Aa^Vha, Aa^Fpa, Gll^Fp, Gd, Gll^Fp, Aa^Fpa, Gll^Fp, Gll^Fp, Aa^Fpa, Aa^Fpa, Aa^Fpa, Ww, Ww, Ww, Gd, Aa, Ai, Aa, Aa, Ww, Ha, Ha, Ms, Mm, Ms, Ms, Ww
Aa^Fpa, Aa^Fpa, Aa^Fpa, Aa^Fpa, Ch, Ch, Ch, Re, Aa^Fpa, Gd, Aa, Aa, Aa, Aa, Gd, Aa^Fpa, Aa^Fpa, Aa^Fpa, Gll^Fp, Aa^Fpa, Aa^Fpa, Aa^Fpa, Aa^Fpa, Aa, Gd, Aa, Ai, Ww, Ww, Gd^Vh, Aa, Aa, Aa, Aa^Fpa, Ha, Ha, Ha, Ha, Ms, Ms, Ms, Ai
Aa^Fpa, Gd, Gd, Gd, Ch, 1 Kh, Ch, Aa^Fpa, Aa^Fpa, Gd, Gd, Gd, Aa, Aa, Gd, Aa^Fpa, Aa^Fpa, Aa^Fpa, Aa^Fpa, Aa^Fpa, Aa^Fpa, Aa^Fpa, Gd, Aa, Aa, Aa, Ai, Ai, Ai, Aa, Aa, Aa, Aa, Aa, Gd, Aa^Fpa, Aa^Fpa, Aa^Fpa, Aa, Ha, Ha, Ha
Aa^Fpa, Aa^Fpa, Gd, Ch, Ch, Ch, Aa^Fpa, Aa^Fpa, Aa^Fpa, Aa^Fpa, Aa^Fpa, Aa^Fpa, Gd, Aa, Aa^Fpa, Gd, Aa^Fpa, Aa^Fpa, Aa^Fpa, Aa^Fpa, Aa^Fpa, Aa^Fpa, Aa, Aa, Aa, Aa, Aa, Ai, Aa, Aa, Aa, Ha, Ha, Aa, Aa, Aa^Vha, Aa^Fpa, Gd, Aa, Aa, Aa, Aa
Aa^Fpa, Gd, Aa, Re, Aa^Fpa, Aa^Fpa, Aa^Fpa, Aa^Fpa, Aa^Fpa, Aa^Fpa, Aa^Fpa, Aa^Fpa, Gd, Aa, Aa, Gd, Gd, Aa^Vha, Aa^Fpa, Aa^Fpa, Aa^Vha, Aa^Fpa, Aa^Fpa, Aa, Aa, Aa, Aa, Aa^Fpa, Aa, Aa, Aa, Ha, Ha, Aa, Aa, Aa^Fpa, Aa^Fpa, Aa^Fpa, Gd, Aa, Aa, Aa
Ww, Ai, Aa, Re, Re, Aa^Vha, Hhd, Aa^Fpa, Aa^Vha, Aa^Fpa, Aa^Fpa, Aa^Fpa, Aa^Fpa, Gd, Aa, Aa, Aa, Gd, Gd, Aa^Fpa, Aa^Fpa, Aa^Fpa, Aa^Fpa, Aa, Aa, Aa, Aa^Fpa, Aa^Fpa, Gd, Aa, Ha, Ha, Ha, Aa, Aa, Gd, Aa^Fpa, Aa^Fpa, Aa^Fpa, Aa, Aa, Aa
Ww, Ai, Ai, Ai, Re, Hhd, Aa^Fpa, Hhd, Aa^Fpa, Aa^Fpa, Aa, Aa, Gd, Aa^Fpa, Gd, Gd, Aa, Gd, Aa^Fpa, Gd, Aa^Fpa, Aa^Fpa, Aa^Fpa, Aa, Aa, Gd, Gd, Aa^Fpa, Aa^Fpa, Gd, Gd, Ha, Ha, Aa, Aa, Aa, Aa^Fpa, Aa^Vha, Aa^Fpa, Aa, Aa, Aa
Aa, Ai, Ai, Ai, Re, Aa^Fpa, Hhd, Hhd, Hhd, Gd, Aa, Aa, Aa, Aa, Gd, Gd, Aa, Aa, Gd, Gd, Ha, Gd, Aa, Aa, Aa, Aa, Aa, Gd, Aa^Fpa, Aa^Fpa, Aa^Fpa, Hhd, Aa^Fpa, Aa^Fpa, Aa, Aa, Gd, Aa^Fpa, Aa, Aa, Aa, Aa
Aa, Ai, Ai, Ai, Ai, Re, Re, Ha, Gd, Aa, Aa, Aa, Aa, Aa, Gd, Aa^Fpa, Aa^Fpa, Gd, Aa, Aa, Aa, Aa, Gd, Gd, Gd, Aa, Aa, Aa, Aa^Fpa, Aa^Fpa, Aa^Vha, Aa^Fpa, Aa^Fpa, Aa^Fpa, Aa^Fpa, Aa^Fpa, Aa^Fpa, Aa^Fpa, Aa, Aa, Aa^Fpa, Aa^Fpa
Ai, Ai, Ai, Ai, Ai, Ai, Re, Aa, Aa, Aa, Aa, Aa, Aa, Gd, Aa^Fpa, Aa^Fpa, Aa^Fpa, Aa^Fpa, Aa, Aa, Aa, Gd, Aa^Fpa, Aa^Fpa, Aa^Fpa, Aa^Fpa, Aa^Fpa, Aa^Fpa, Aa^Fpa, Aa^Fpa, Aa^Fpa, Gll^Fp, Aa^Fpa, Aa^Fpa, Aa^Fpa, Gll^Fp, Aa^Fpa, Aa^Fpa, Aa, Aa, Gd, Gd
Ai, Ai, Ww, Ai, Ai, Ai, Aa, Re, Aa, Aa, Aa, Aa, Aa, Aa, Aa^Fpa, Aa^Fpa, Gd, Gd, Aa, Aa, Aa, Aa^Fpa, Aa^Fpa, Aa^Fpa, Aa^Fpa, Aa^Vha, Aa^Fpa, Aa^Fpa, Aa^Fpa, Aa^Fpa, Aa^Fpa, Aa^Fpa, Aa^Fpa, Gll^Fp, Gll^Fp, Aa^Fpa, Aa^Fpa, Aa^Fpa, Gd, Aa, Aa, Aa
Hhd, Ww, Ww, Ai, Ai, Ai, Ai, Re, Aa, Aa, Aa, Aa, Aa, Aa, Ww, Aa^Fpa, Aa, Gd, Gd, Aa, Aa, Hhd, Aa^Fpa, Aa^Fpa, Gll^Fp, Aa^Fpa, Aa^Fpa, Aa^Fpa, Aa^Fpa, Aa^Fpa, Gd, Gd, Aa^Fpa, Gll^Fp, Aa^Fpa, Aa^Fpa, Aa^Fpa, Aa^Fpa, Gd, Aa, Aa, Aa
Gll^Fp, Ww, Ww, Ai, Ai, Aa, Aa, Re, Aa, Aa, Aa, Aa, Aa, Ai, Wo, Ww, Aa, Aa^Fpa, Aa^Fpa, Aa^Fpa, Aa, Aa^Fpa, Aa^Vha, Aa^Fpa, Aa^Fpa, Aa^Fpa, Aa^Fpa, Aa^Fpa, Gd, Aa, Aa, Aa, Gd, Aa^Fpa, Aa^Fpa, Aa^Fpa, Aa^Fpa, Aa^Fpa, Aa, Aa, Aa, Aa
Ww, Ww, Ww, Ai, Ai, Ha, Aa, Re, Re, Aa, Aa, Aa, Ai, Ww, Ww, Ww, Gd, Aa^Fpa, Aa^Fpa, Aa^Fpa, Aa^Fpa, Aa^Fpa, Aa^Fpa, Aa^Fpa, Aa^Fpa, Aa^Fpa, Aa^Fpa, Gd, Gd, Aa, Aa, Aa, Aa, Gd, Aa^Fpa, Aa^Fpa, Aa^Fpa, Aa^Fpa, Ww, Ai, Aa^Vha, Aa
Gll^Fp, Ww, Ww, Ai, Ai, Ha, Aa, Aa^Vha, Re, Aa, Re, Aa, Re, Gd, Aa^Fpa, Aa^Fpa, Aa^Fpa, Aa^Fpa, Gd, Gd, Gd, Aa^Fpa, Aa^Fpa, Aa, Gd, Aa^Fpa, Gd, Aa, Aa, Aa, Aa, Aa, Aa, Gd, Aa^Fpa, Aa^Fpa, Aa^Fpa, Aa^Fpa, Ww, Ww, Ww, Aa^Fpa
Aa^Fpa, Ww, Ww, Ai, Ai, Aa, Aa, Re, Aa, Re, Aa, Re, Aa, Re, Re, Aa^Vha, Aa^Fpa, Aa, Aa, Gd, Aa, Aa, Aa, Aa, Aa, Gd, Gd, Aa, Aa, Aa, Aa, Aa, Aa, Gd, Aa^Vha, Aa^Fpa, Aa^Fpa, Aa^Fpa, Ww, Ww, Ww, Ww
Aa, Aa, Ai, Ha^Vhha, Ha, Aa, Re, Re, Aa, Aa, Aa, Aa, Gd, Aa^Fpa, Re, Aa^Fpa, Aa^Fpa, Gd, Gd, Aa, Aa, Aa, Aa, Gd, Aa^Vha, Aa^Fpa, Aa^Fpa, Aa^Fpa, Aa, Aa, Aa, Gd, Aa^Fpa, Aa^Fpa, Aa^Fpa, Aa^Fpa, Aa^Fpa, Aa^Vha, Aa^Fpa, Ww, Ww, Ww
Aa, Aa, Aa, Aa, Ha, Re, Ha, Aa, Aa, Aa, Aa, Gd, Aa^Fpa, Aa^Fpa, Re, Aa^Vha, Aa^Fpa, Aa^Fpa, Aa, Aa, Aa^Vha, Aa, Aa, Aa^Fpa, Aa^Fpa, Gll^Fp, Gll^Fp, Aa^Fpa, Gd, Aa^Fpa, Aa^Fpa, Aa^Fpa, Aa^Fpa, Gll^Fp, Gll^Fp, Aa^Fpa, Aa^Fpa, Aa^Fpa, Aa^Fpa, Ww, Ww, Ww
Aa, Aa, Aa, Aa, Re, Re, Aa, Aa, Aa, Aa, Gd, Hhd, Aa^Fpa, Aa, Re, Aa^Fpa, Aa^Fpa, Aa, Aa, Ha, Aa, Aa, Aa, Aa^Fpa, Gll^Fp, Gd, Gd, Gll^Fp, Aa^Fpa, Aa^Fpa, Aa^Fpa, Gll^Fp, Gll^Fp, Aa^Fpa, Aa^Fpa, Aa^Fpa, Gd, Gd, Aa^Fpa, Aa^Fpa, Aa^Fpa, Aa^Fpa
Aa, Aa, Aa, Re, Gd, Aa^Fpa, Aa^Fpa, Aa^Fpa, Aa^Fpa, Gd, Aa^Fpa, Aa^Fpa, Aa^Fpa, Aa, Re, Aa, Aa, Ha, Ha, Ha, Ha, Ha, Aa^Fpa, Gll^Fp, Gd, Gll^Fp, Gll^Fp, Gd, Gll^Fp, Gll^Fp, Aa^Fpa, Aa^Fpa, Gll^Fp, Aa^Fpa, Aa^Fpa, Aa^Fpa, Aa, Aa, Aa, Gd, Aa^Fpa, Aa^Fpa
Aa, Aa, Aa, Re, Re, Aa^Fpa, Aa^Fpa, Aa^Fpa, Aa^Fpa, Aa^Fpa, Aa^Fpa, Gd, Gd, Gd, Aa, Re, Re, Ha, Ha, Ms, Ms, Hhd, Hhd, Aa^Fpa, Aa^Fpa, Aa^Fpa, Aa^Fpa, Gll^Fp, Gll^Fp, Aa^Fpa, Aa^Fpa, Aa^Fpa, Aa^Fpa, Aa^Fpa, Gd, Aa, Aa, Aa, Aa, Aa, Aa^Fpa, Aa^Fpa
Aa, Aa, Aa, Aa^Vha, Re, Aa^Fpa, Aa^Fpa, Aa^Fpa, Aa^Fpa, Aa^Fpa, Aa^Fpa, Gd, Ai, Aa, Gd, Aa, Re, Ha, Ms, Ms, Ms, Ha, Hhd, Aa^Fpa, Aa^Fpa, Aa^Fpa, Aa^Fpa, Aa^Fpa, Aa^Fpa, Aa^Fpa, Gd, Gd, Aa^Fpa, Aa^Vha, Aa^Fpa, Aa^Fpa, Aa, Aa, Aa, Gd, Aa^Fpa, Aa^Fpa
Aa, Aa, Re, Re, Gd, Aa^Fpa, Aa^Fpa, Aa^Fpa, Ww, Ww, Ww, Ww, Ww, Aa^Fpa, Aa^Fpa, Aa^Fpa, Re, Ha, Ms, Ms, Ms, Ha, Aa, Aa^Fpa, Aa^Fpa, Gd, Aa, Gd, Aa, Aa, Aa, Aa, Gd, Aa^Fpa, Aa^Fpa, Aa^Fpa, Aa^Fpa, Gd, Gd, Aa^Fpa, Gll^Fp, Hhd
Aa^Fpa, Gd, Re, Gd, Gd, Aa^Fpa, Aa^Fpa, Aa^Fpa, Ww, Ww, Ww, Ww, Ww, Ww, Aa^Fpa, Re, Aa^Fpa, Ha, Ha, Ms, Ms, Ha, Aa, Aa, Gd, Aa, Aa, Aa, Aa, Aa, Aa, Aa, Aa, Gd, Aa^Fpa, Aa^Fpa, Aa^Fpa, Aa^Fpa, Aa^Fpa, Gll^Fp, Hhd, Hhd
Aa^Fpa, Aa^Fpa, Re, Aa, Gd, Aa^Fpa, Gd, Ww, Ww, Ww, Ww, Ww, Ww, Gll^Fp, Aa^Fpa, Re, Ha, Ha, Ms, Ms, Ha, Ha, Aa, Aa, Aa, Aa, Aa^Vha, Aa, Aa, Aa, Aa, Aa, Aa, Aa, Gd, Aa, Aa, Aa^Fpa, Aa^Fpa, Gll^Fp, Hhd, Hhd
Re, Re, Re, Gd, Aa^Fpa, Aa^Fpa, Aa^Fpa, Gd, Gd, Aa^Fpa, Aa^Vha, Aa^Fpa, Ww, Aa^Fpa, Aa^Fpa, Re, Aa^Fpa, Hhd, Mm, Ha, Ha, Aa, Aa, Aa, Aa, Aa, Aa, Aa, Aa, Aa, Aa, Aa, Aa, Aa, Gd, Gd, Gd, Aa^Fpa, Aa^Vha, Aa^Fpa, Gll^Fp, Hhd
Aa^Fpa, Aa^Fpa, Re, Gd^Vh, Ww, Ww, Gd, Aa^Fpa, Gd, Aa^Fpa, Aa^Fpa, Aa^Fpa, Ww, Aa^Vha, Aa^Fpa, Re, Re, Hhd, Mm, Ha, Aa, Aa, Aa, Aa, Aa, Aa, Aa, Aa, Aa, Aa, Aa^Vha, Aa, Aa, Aa, Aa, Gd, Gd, Gd, Aa^Fpa, Aa^Fpa, Aa^Fpa, Aa^Fpa
Re, Re, Gd, Ww, Ww, Ww, Ai, Aa^Fpa, Aa^Fpa, Gll^Fp, Gll^Fp, Ww, Aa^Fpa, Gd, Hhd, Hhd, Hhd, Re, Re, Aa^Fpa, Aa^Vha, Aa, Aa, Aa, Aa, Aa, Aa, Aa, Aa, Aa, Aa, Aa, Aa, Aa, Aa, Aa, Ai, Aa, Aa, Gd, Aa^Fpa, Aa^Fpa
Aa^Fpa, Aa^Fpa, Aa^Fpa, Ww, Ww, Ww, Ai, Aa^Fpa, Aa^Vha, Aa^Fpa, Gll^Fp, Ww, Gd, Aa, Ha, Mm, Mm, Hhd, Hhd, Re, Re, Aa, Aa, Ai, Aa, Aa, Aa, Aa, Aa, Aa, Aa, Aa, Aa, Aa, Aa, Aa, Ai, Aa, Ai, Aa, Aa, Aa
Gll^Fp, Gll^Fp, Aa^Fpa, Ww, Gd, Aa, Aa, Aa^Fpa, Aa^Fpa, Aa^Fpa, Aa^Fpa, Ww, Ha, Ha, Ha, Hhd, Mm, Hhd, Hhd, Gll^Fp, Re, Aa, Aa, Aa, Aa, Aa, Aa, Aa, Aa, Aa, Aa, Aa, Aa, Aa, Aa, Aa, Aa, Ai, Ww, Gd, Aa, Aa
Gd, Gll^Fp, Aa^Fpa, Gd, Aa, Aa, Aa, Aa^Fpa, Aa^Fpa, Aa^Fpa, Aa^Fpa, Ai, Ha, Ha, Ha, Ha, Mm, Mm, Hhd, Hhd, Gd, Re, Aa, Aa, Aa, Aa, Aa, Aa, Aa, Aa, Aa, Aa, Aa, Aa, Aa, Aa, Gd, Aa^Fpa, Aa^Vha, Aa^Fpa, Aa, Aa
Gd, Gll^Fp, Aa^Fpa, Gd, Aa, Aa, Gd, Aa^Fpa, Aa^Fpa, Aa^Fpa, Aa^Fpa, Ai, Aa, Aa, Aa, Ha, Ha, Ha, Hhd, Hhd, Re, Re, Aa, Aa, Aa, Aa, Aa^Vha, Aa, Aa, Aa, Aa, Aa, Aa, Aa, Aa, Aa, Aa^Fpa, Gd, Gd, Aa, Aa, Aa
Re, Aa^Fpa, Aa^Fpa, Aa^Fpa, Aa, Ha, Hhd, Hhd, Aa^Fpa, Gll^Fp, Ww, Ww, Aa, Aa, Aa, Aa^Fpa, Aa^Fpa, Aa^Fpa, Aa^Fpa, Gd, Re, Aa, Aa, Aa^Fpa, Aa^Fpa, Aa, Aa, Aa, Aa, Aa, Aa, Aa, Aa, Aa, Aa, Aa, Aa, Aa, Aa, Aa, Aa, Aa
Re, Gll^Fp, Gll^Fp, Aa^Fpa, Gd, Ha, Hhd, Hhd, Ww, Ww, Ww, Aa^Fpa, Aa^Fpa, Aa, Gd, Aa^Fpa, Aa^Fpa, Aa^Fpa, Aa^Fpa, Aa^Vha, Aa^Fpa, Re, Re, Ch, Ch, Ch, Gd, Aa, Aa, Aa, Aa, Aa^Vha, Aa, Aa, Aa, Aa, Aa, Aa, Aa, Aa, Aa, Aa
Re, Gd, Gd, Aa^Fpa, Aa^Vha, Gd, Aa^Fpa, Ww, Ww, Ww, Ww, Hhd, Aa^Fpa, Gd, Aa^Fpa, Aa^Vha, Aa^Fpa, Gll^Fp, Gll^Fp, Gll^Fp, Gll^Fp, Aa^Fpa, Aa^Fpa, Ch, 2 Kh, Ch, Aa^Fpa, Gd, Ha, Ha, Aa, Aa, Aa, Aa, Aa, Aa, Aa, Aa, Aa, Aa, Aa, Aa
Gd, Re, Gd, Gll^Fp, Aa^Fpa, Ww, Ai, Ww, Ww, Ww, Ww, Ww, Ww, Ha, Aa^Fpa, Aa^Fpa, Gll^Fp, Gll^Fp, Gll^Fp, Gd, Gll^Fp, Gll^Fp, Ch, Ch, Ch, Aa^Fpa, Aa^Fpa, Aa^Fpa, Ha, Ha, Aa, Gd, Gd, Aa, Aa, Aa, Aa, Aa, Aa^Fpa, Gd, Aa^Fpa, Gd
Gd, Re, Gd, Gll^Fp, Aa^Fpa, Aa, Ww, Ai, Ai, Ww, Ww, Ww, Ms, Mm, Aa^Fpa, Aa^Fpa, Gll^Fp, Gll^Fp, Gll^Fp, Gll^Fp, Gll^Fp, Aa^Fpa, Aa^Fpa, Aa^Fpa, Aa^Fpa, Aa^Fpa, Aa^Fpa, Aa^Fpa, Aa^Fpa, Aa, Aa, Gd, Gd, Aa, Aa, Aa, Aa, Aa^Fpa, Aa^Fpa, Aa^Fpa, Aa^Fpa, Aa^Fpa
Gll^Fp, Re, Gd, Aa^Fpa, Gd, Aa, Gd, Ai, Ai, Ai, Ai, Ms, Ms, Mm, Hhd, Aa^Fpa, Aa^Fpa, Aa^Fpa, Aa^Fpa, Aa^Fpa, Aa^Fpa, Aa^Fpa, Aa^Fpa, Aa^Fpa, Aa^Fpa, Aa^Fpa, Aa^Fpa, Aa^Fpa, Aa^Fpa, Gd, Gd, Gd, Aa, Aa, Aa, Aa, Aa, Aa^Fpa, Gll^Fp, Gll^Fp, Gd, Gll^Fp
Aa^Fpa, Re, Aa^Fpa, Gd, Aa, Aa, Gd, Ha, Mm, Mm^Vhh, Mm, Mm, Ms, Hhd, Hhd, Aa^Fpa, Aa^Fpa, Aa^Fpa, Aa^Fpa, Aa^Fpa, Aa^Fpa, Aa^Fpa, Gd, Aa^Fpa, Gd, Aa^Fpa, Aa^Fpa, Aa^Vha, Gd, Gd, Gd, Aa, Aa, Aa, Aa, Aa, Aa, Aa^Fpa, Aa^Fpa, Gd, Gd, Gd
Re, Re, Aa, Aa, Aa, Aa, Gd, Hhd, Mm, Mm, Mm, Mm, Ms, Ms, Hhd, Aa^Fpa, Aa^Fpa, Gd, Gd, Gd, Aa^Fpa, Aa^Fpa, Aa^Fpa, Aa, Aa, Aa, Aa, Aa, Aa, Gd, Gd, Aa, Aa, Aa, Aa, Aa, Aa, Aa^Fpa, Aa^Fpa, Gll^Fp, Gd, Gd
