Aa^Fpa, Aa, Aa, Aa, Gd, Aa^Fpa, Gll^Fp, Aa^Fpa, Gd, Gd, Gd, Gd, Gd, Aa^Fpa, Ww, Gll^Fp, Gll^Fp, Gll^Fp, Aa^Fpa, Gd, Gd, Gd, Gd, Aa^Fpa, Gd, Gd, Aa, Gd, Gd, Gd, Gd, Gd, Gd, Aa^Fpa, Ww, Ww, Ww, Wo, Ww, Ww, Ww, Ww
Gd, Aa, Aa, Aa, Gd, Aa^Vha, Aa^Fpa, Aa^Fpa, Gd, Gd, Gd, Aa^Fpa, Aa^Fpa, Gll^Fp, Gd^Vh, Gd, Gd, Gd, Gll^Fp, Aa^Fpa, Aa^Fpa, Aa^Fpa, Aa^Fpa, Aa^Fpa, Aa^Fpa, Gd, Aa, Gd, Gd, Gd, Gd, Gd, Aa^Fpa, Gll^Fp, Ww, Ww, Ww, Wo, Ww, Ww, Ww^Bw/, Ww
Aa, Aa, Aa, Aa, Gd, Gd, Gd, Gd, Gd, Gd, Gd, Aa^Vha, Gll^Fp, Gll^Fp, Gd, Gd, Gd, Gd, Gll^Fp, Gll^Fp, Gll^Fp, Gll^Fp, Aa^Fpa, Gd, Gd, Gd, Gd, Gd, Gd, Gd, Aa^Fpa, Gll^Fp, Gll^Fp, Gll^Fp, Ww, Ww, Ww, Wo, Ww, Ww^Bw/, Ww, Ww
Aa, Aa, Aa, Aa, Aa, Aa, Aa, Aa, Aa, Gd, Gd, Aa^Fpa, Gll^Fp, Gd, Gll^Fp, Gll^Fp, Aa^Fpa, Gll^Fp, Gd, Gd, Gd, Gll^Fp, Aa^Fpa, Gd, Gd, Gd^Vh, Gd, Gd, Aa, Gd, Gd, Gd, Gd, Gd, Gd, Ww, Ww, Ww, Ww, Wo, Wo, Wo
Aa, Aa, Aa, Aa, Aa, Aa, Aa, Aa, Aa, Gd, Gd, Aa^Fpa, Gll^Fp, Gll^Fp, Gll^Fp, Aa^Fpa, Gd, Aa^Fpa, Gll^Fp, Gd, Gll^Fp, Gll^Fp, Aa^Fpa, Aa^Fpa, Gd, Gd, Gd, Gd, Aa, Gd, Gll^Fp, Gd, Gd, Gd, Re, Ww, Ww^Bw/, Ww^Bw/, Ww, Ww, Wo, Wo
Aa, Aa, Aa, Aa, Aa, Aa, Aa, Aa, Aa, Aa, Gd, Aa^Fpa, Gll^Fp, Gll^Fp, Aa^Fpa, Gd, Gd, Aa^Fpa, Gll^Fp, Gll^Fp, Gll^Fp, Gll^Fp, Gll^Fp, Aa^Fpa, Gd, Gd, Gd, Gd, Ch, Ch, Ch, Gll^Fp, Re, Re, Gd, Re, Ww, Ww, Ww, Ww, Ww, Wo
Aa, Aa, Ha, Ha, Ha, Aa, Aa, Aa, Aa, Gd, Gd, Aa^Fpa, Aa^Fpa, Aa^Fpa, Aa^Fpa, Gd, Gd, Gd, Aa^Fpa, Aa^Fpa, Hhd, Hhd, Aa^Fpa, Gd, Gd, Gd, Gd, Aa^Fpa, Ch, 1 Kh, Ch, Re, Gd^Vh, Gd, Gd, Gd, Gd, Gd, Gll^Fp, Gd^Vh, Ww, Ww
Aa, Aa, Ha, Ha, Ha, Aa, Aa, Aa, Gd, Gd, Gd, Aa^Fpa, Gll^Fp, Aa^Fpa, Aa^Vha, Gd, Gd, Gd, Gd, Aa^Vha, Aa^Fpa, Hhd, Aa, Gd, Aa^Fpa, Aa^Fpa, Gll^Fp, Ch, Ch, Ch, Gll^Fp, Gll^Fp, Gll^Fp, Gd, Gd, Gd, Gd, Gd, Gll^Fp, Gd, Ai, Ww
Aa, Aa, Ha, Ha, Ha, Ha, Aa, Gd, Gd, Gd, Aa, Gd, Aa^Fpa, Aa^Fpa, Aa^Fpa, Aa^Fpa, Aa^Fpa, Aa^Fpa, Gd, Gd, Gd, Aa, Aa, Aa, Gd, Aa^Fpa, Gll^Fp, Gd, Re, Re, Gll^Fp, Aa^Fpa, Aa^Fpa, Gll^Fp, Gd, Gd, Gd, Gd, Aa^Fpa, Gd, Aa, Ai
Aa, Aa, Ha, Ha, Ha, Hhd, Aa^Vha, Aa^Fpa, Aa^Vha, Gd, Gd, Aa, Gd, Gd, Gd, Aa^Fpa, Aa^Fpa, Gd, Aa, Aa, Aa, Aa, Aa, Aa, Aa^Fpa, Gll^Fp, Gd, Gd^Vh, Re, Gll^Fp, Aa^Fpa, Gd, Gd, Aa^Fpa, Gll^Fp, Gd, Gd, Gll^Fp, Aa^Fpa, Aa, Gd, Gd
Gd, Aa^Fpa, Aa^Fpa, Gll^Fp, Gll^Fp, Gd, Gd, Gd, Gll^Fp, Gd, Gd, Gd, Aa, Aa, Gd, Aa^Fpa, Aa^Fpa, Ww, Aa, Aa, Aa, Aa, Aa, Aa, Aa^Fpa, Gd, Re, Re, Gd, Gd, Gll^Fp, Aa^Fpa, Gd, Gd, Aa^Fpa, Aa^Fpa, Aa^Fpa, Aa^Fpa, Aa, Aa, Aa, Aa
Gd, Aa^Fpa, Gd, Gd, Gd, Gd, Gd, Gd, Gll^Fp, Aa^Fpa, Gd, Gd, Aa, Aa, Aa^Fpa, Aa^Fpa, Ww, Ai, Aa, Aa, Aa, Gd, Gd, Aa^Fpa, Gll^Fp, Gll^Fp, Re, Gd, Gd, Gd, Gll^Fp, Gll^Fp, Gd, Gd, Aa, Gd, Gd, Gd, Aa, Aa, Aa, Aa
Aa^Fpa, Aa^Fpa, Gd, Gd, Gd, Gd, Gd, Aa^Fpa, Gll^Fp, Aa^Fpa, Gd, Gd, Aa, Aa, Gd, Gd, Gd, Aa, Aa, Aa, Gd, Aa^Fpa, Aa^Fpa, Gll^Fp, Re, Re, Aa^Fpa, Gll^Fp, Gd, Gd, Gll^Fp, Aa^Fpa, Ww, Aa, Aa, Aa, Gd, Gd, Aa, Aa, Aa, Gd
Aa^Fpa, Aa^Vha, Gll^Fp, Gd, Gd, Gd, Gll^Fp, Aa^Fpa, Aa^Vha, Aa^Fpa, Aa^Fpa, Gd, Aa, Aa, Gd, Gd, Gd, Aa, Aa, Aa, Gd, Aa^Fpa, Gll^Fp, Re, Gll^Fp, Gll^Fp, Aa^Fpa, Gll^Fp, Gll^Fp, Gll^Fp, Aa^Fpa, Aa^Fpa, Gd, Aa, Aa, Aa, Gd, Gd, Aa, Aa, Aa, Aa^Fpa
Gll^Fp, Gll^Fp, Gd, Gd, Gd, Gd, Gll^Fp, Aa^Fpa, Aa^Fpa, Aa^Fpa, Aa^Fpa, Gd, Gd, Gd, Gd, Gd, Aa, Aa, Aa, Aa, Re, Gll^Fp, Re, Re, Hhd, Aa^Fpa, Aa^Fpa, Gll^Fp, Aa^Fpa, Aa^Fpa, Aa^Fpa, Aa^Fpa, Gd, Aa, Aa, Aa^Fpa, Aa^Vha, Aa^Fpa, Gd, Aa, Aa, Gd
Aa^Fpa, Gll^Fp, Gll^Fp, Gd, Gd, Gd, Gll^Fp, Gll^Fp, Gll^Fp, Gll^Fp, Aa^Fpa, Gd, Gd, Gd, Aa^Fpa, Gd, Gd, Aa, Re, Re, Aa^Fpa, Re, Gll^Fp, Hhd, Hhd, Hhd, Aa^Fpa, Aa^Fpa, Gd, Gd, Gd, Aa^Fpa, Gd, Gd, Aa, Gd, Aa^Fpa, Aa^Vha, Gd, Aa, Aa, Gd
Aa^Fpa, Gll^Fp, Gll^Fp, Gll^Fp, Gll^Fp, Gll^Fp, Gll^Fp, Gll^Fp, Gll^Fp, Aa^Fpa, Aa^Fpa, Gd, Gd, Aa^Fpa, Aa^Vha, Gd, Re, Re, Aa^Fpa, Aa^Vha, Aa^Fpa, Aa^Fpa, Aa^Fpa, Gd, Hhd, Hhd, Ha, Hhd, Ha, Gd, Gd, Gd, Gd, Gd, Gd, Gd, Gd, Aa^Fpa, Gd, Aa, Aa, Aa
Ww, Aa^Fpa, Aa^Fpa, Ww, Ww, Ww, Gd, Gd, Gd, Gll^Fp, Aa^Fpa, Aa^Fpa, Re, Re, Re, Re, Aa^Fpa, Aa^Fpa, Aa^Fpa, Aa^Fpa, Gll^Fp, Gll^Fp, Gll^Fp, Aa^Fpa, Aa^Fpa, Ha, Ha, Ha, Ha, Ha, Aa, Gd, Gd, Gd, Gd, Gd, Gd, Gd, Gd, Aa, Aa, Aa
Ww, Ww, Gd, Aa, Ww, Ww, Ww, Gd, Gd, Gd, Gll^Fp, Re, Gd, Gd, Gd, Gd, Aa^Fpa, Aa^Fpa, Aa^Fpa, Aa^Fpa, Gll^Fp, Gll^Fp, Aa^Fpa, Aa^Fpa, Gd, Hhd, Ha, Ha^Vhha, Ha, Aa, Aa, Aa, Aa, Gd, Gd, Ha, Ha, Aa, Aa, Aa, Aa, Aa
Ww, Ai, Aa, Aa, Aa^Vha, Aa^Fpa, Gll^Fp, Gll^Fp, Gd, Gd, Aa^Fpa, Re, Aa, Ha, Gd, Gd, Gd, Hhd, Aa^Fpa, Aa^Vha, Aa^Fpa, Gll^Fp, Gd, Aa^Fpa, Aa^Fpa, Aa^Fpa, Hhd, Ha, Aa, Aa, Aa, Aa, Aa, Aa, Ms, Ms, Ha, Ha, Aa, Aa, Aa, Aa
Ww, Ai, Aa, Aa, Aa, Gd, Aa^Fpa, Gll^Fp, Aa^Fpa, Aa^Fpa, Aa, Re, Aa, Ha, Ha, Ha, Ha, Hhd, Aa^Vha, Aa^Fpa, Aa^Fpa, Gll^Fp, Gll^Fp, Aa^Fpa, Aa^Fpa, Aa^Fpa, Hhd, Aa, Aa, Aa, Aa^Vha, Aa, Aa, Ha, Ms, Ms, Ms, Ha, Aa, Gd, Gd, Gd
Ai, Ai, Aa, Aa, Aa, Aa^Fpa, Gll^Fp, Gll^Fp, Gll^Fp, Gd, Aa, Re, Aa, Ha, Ha, Ms, Ms, Ha, Aa^Fpa, Aa^Fpa, Aa^Fpa, Aa^Fpa, Gll^Fp, Gll^Fp, Aa^Fpa, Aa^Fpa, Gd, Aa, Aa, Aa, Aa, Aa, Aa, Aa, Ha, Ha, Ha, Aa, Aa^Vha, Aa, Gd, Aa^Fpa
Aa, Aa, Aa, Aa, Aa, Aa^Fpa, Gll^Fp, Gll^Fp, Aa^Fpa, Gd, Aa, Re, Re, Aa, Ha, Ha, Ms, Hhd, Hhd, Aa^Fpa, Gll^Fp, Gll^Fp, Gll^Fp, Gll^Fp, Aa^Fpa, Gd, Aa, Aa, Aa, Aa, Aa, Gd, Gd, Aa, Aa, Aa, Aa, Aa, Aa, Aa, Gd, Gd
Aa, Aa, Aa, Aa, Aa, Gd, Aa^Fpa, Aa^Vha, Aa^Fpa, Aa, Aa, Aa, Re, Aa, Aa, Gd, Aa^Fpa, Hhd, Gll^Fp, Gll^Fp, Gll^Fp, Gd, Gll^Fp, Aa^Fpa, Gd, Gd, Aa, Aa, Aa, Aa, Aa, Gd, Aa^Fpa, Gd, Aa, Aa, Aa, Aa, Aa, Gd, Aa, Aa
Aa, Aa, Aa, Aa, Aa, Gd, Gd, Gd, Gd, Aa, Aa, Re, Aa, Aa, Aa, Gd, Aa^Fpa, Gll^Fp, Gd, Gd, Gd, Gd, Gll^Fp, Aa^Fpa, Gd, Aa, Aa^Vha, Aa, Aa, Aa, Aa, Gd, Gd, Gd, Aa, Aa, Aa, Aa, Aa, Aa, Aa, Aa
Gd, Aa, Aa, Aa, Aa, Aa, Aa, Aa, Gd, Gd, Aa, Re, Gd, Aa, Gd, Gd, Aa^Fpa, Aa^Fpa, Gll^Fp, Gd, Gd, Gd, Gd, Gll^Fp, Gd, Aa, Aa, Aa, Aa, Aa, Aa, Aa, Aa, Gd, Aa, Aa, Aa, Aa, Aa, Aa, Aa, Gd
Aa^Fpa, Gd, Aa, Aa, Aa, Aa, Aa, Aa, Aa, Aa, Gd, Re, Aa^Fpa, Gd, Gd, Gd, Gd, Aa^Fpa, Gll^Fp, Gll^Fp, Gll^Fp, Gll^Fp, Gd, Gll^Fp, Aa^Fpa, Gd, Aa, Aa, Aa, Aa, Aa, Aa, Aa, Aa, Aa, Aa, Aa, Aa, Aa, Aa, Gd, Gd
Gd, Gll^Fp, Aa^Fpa, Aa, Aa, Aa, Aa, Aa, Aa, Gd, Aa^Fpa, Re, Ww, Aa^Fpa, Gd, Gd, Aa^Fpa, Aa^Fpa, Aa^Fpa, Gll^Fp, Gll^Fp, Gll^Fp, Gll^Fp, Gll^Fp, Gll^Fp, Gd, Gd, Aa, Aa, Aa, Aa, Aa, Aa, Aa, Aa, Aa, Aa, Aa, Gd, Gd, Gd, Gd
Gd, Gd, Gll^Fp, Aa^Fpa, Aa, Aa, Aa, Aa, Gd, Aa^Fpa, Gll^Fp, Ww^Bw|, Ww, Aa^Fpa, Gd^Vh, Gd, Aa^Fpa, Aa^Fpa, Aa^Fpa, Gll^Fp, Gll^Fp, Gll^Fp, Gll^Fp, Gd, Gll^Fp, Aa^Fpa, Gd, Aa, Aa, Aa, Aa, Aa, Aa, Aa, Aa, Gd, Gd, Gd, Aa^Fpa, Aa^Vha, Aa^Fpa, Gd
Hhd, Gd, Gd, Gll^Fp, Gd, Gd, Gd, Gd, Gd, Aa^Fpa, Gll^Fp, Re, Gll^Fp, Aa^Fpa, Ww, Ww, Ww, Ww, Aa^Fpa, Gll^Fp, Gd, Gd, Gll^Fp, Gll^Fp, Ww, Aa^Fpa, Aa^Fpa, Gd, Aa, Gd, Gd, Aa, Aa, Gd, Gd, Aa^Fpa, Gll^Fp, Aa^Fpa, Gll^Fp, Gll^Fp, Aa^Fpa, Gd
Hhd, Gd, Gd, Gll^Fp, Aa^Fpa, Gd, Aa^Fpa, Aa^Fpa, Aa^Fpa, Gd, Gd, Re, Gll^Fp, Ww, Ai, Ww, Ww, Ww, Gd, Gd, Gd, Gd^Vh, Gd, Ww, Ww, Ww, Aa^Fpa, Aa^Fpa, Gd, Aa^Fpa, Gd, Gd, Aa, Aa^Vha, Aa^Fpa, Gll^Fp, Gll^Fp, Gd, Gll^Fp, Aa^Fpa, Gd, Aa
Gd, Gd, Gll^Fp, Gll^Fp, Ww, Ww, Ww, Aa^Vha, Gll^Fp, Gd, Gd, Re, Gll^Fp, Gd, Aa, Ai, Ww, Gll^Fp, Gd, Gd, Ww, Ww, Ww, Ww, Ww, Gll^Fp, Gll^Fp, Gll^Fp, Gll^Fp, Gll^Fp, Aa^Fpa, Gd, Gd, Aa^Fpa, Gll^Fp, Gll^Fp, Gd, Gd, Gd, Aa^Fpa, Aa, Aa
Gll^Fp, Gll^Fp, Gll^Fp, Gll^Fp, Ww, Ww, Ww, Ww, Gd, Gd, Gd, Re, Aa^Fpa, Gd, Aa, Aa, Gd^Vh, Gll^Fp, Gd, Gd, Ww, Ww, Ww, Ww, Ww, Gd^Vh, Gll^Fp, Gll^Fp, Gll^Fp, Gd, Gll^Fp, Aa^Fpa, Gd, Aa^Fpa, Gll^Fp, Gll^Fp, Gd, Gd^Vh, Gll^Fp, Aa^Fpa, Aa, Aa
Aa^Fpa, Aa^Fpa, Gll^Fp, Aa^Fpa, Ww, Ww, Ww, Ww, Gd, Gd, Re, Re, Aa^Fpa, Gd, Aa, Aa, Gd, Aa^Fpa, Gd, Gd, Ww, Ww, Ww, Gd, Gd, Gd, Gd, Gd, Gd, Gll^Fp, Gll^Fp, Gd, Gd, Aa^Vha, Aa^Fpa, Gd, Gd, Ww, Ww, Aa^Fpa, Aa, Aa
Gd, Aa^Fpa, Aa^Fpa, Ww, Ww, Ww, Ww, Ww, Gd^Vh, Re, Gd, Gd, Aa^Fpa, Gd, Aa, Aa, Aa, Gd, Aa^Fpa, Gd, Ww, Ww, Gd^Vh, Gd, Gd, Gd, Gd, Gd, Gll^Fp, Gll^Fp, Aa^Fpa, Aa, Gd, Aa^Fpa, Gll^Fp, Gll^Fp, Gll^Fp, Ww, Ww, Ww, Aa, Aa
Aa, Aa, Gd, Aa, Ww, Ww, Aa^Fpa, Ch, Ch, Ch, Gll^Fp, Gll^Fp, Aa^Fpa, Gd, Aa, Aa, Aa, Aa, Gd, Aa^Fpa, Gll^Fp, Gll^Fp, Gll^Fp, Aa^Fpa, Gll^Fp, Gll^Fp, Gll^Fp, Gll^Fp, Gll^Fp, Aa^Fpa, Gd, Aa, Aa, Gd, Aa^Fpa, Aa^Fpa, Gll^Fp, Ww, Ww, Ai, Aa, Aa
Aa, Aa, Aa, Aa, Gd^Vh, Ww, Aa^Fpa, Ch, 2 Kh, Ch, Aa^Fpa, Aa^Fpa, Aa^Fpa, Gd, Gd, Aa, Aa, Aa, Aa, Gd, Gd, Gd, Gd, Gd, Aa^Fpa, Aa^Fpa, Aa^Fpa, Aa^Fpa, Aa^Fpa, Aa^Fpa, Gd, Aa, Aa, Aa, Gd, Aa^Fpa, Aa^Fpa, Ww, Ww, Aa, Aa, Aa
Aa, Aa, Aa, Aa, Gd, Aa^Fpa, Ch, Ch, Ch, Aa^Fpa, Gll^Fp, Gll^Fp, Aa^Fpa, Aa^Fpa, Gd, Aa, Aa, Aa, Aa, Aa, Gd, Gd, Gd, Gd, Aa, Aa, Gd, Gd, Aa^Fpa, Gd, Aa, Aa, Aa, Aa, Gd, Aa^Fpa, Ww, Ww, Gd^Vh, Gd, Aa, Aa
Aa, Aa, Aa, Gd, Aa^Fpa, Gll^Fp, Gll^Fp, Aa^Fpa, Re, Aa^Fpa, Gll^Fp, Gd, Gll^Fp, Aa^Fpa, Gd, Aa, Aa, Aa, Aa, Aa, Gd, Aa^Fpa, Aa^Fpa, Gd, Aa, Aa, Aa, Aa, Aa, Gd, Gd, Aa, Aa, Aa, Gd, Aa^Fpa, Aa^Fpa, Ww, Gd, Gd, Aa, Aa
Aa, Aa, Aa, Aa^Fpa, Gll^Fp, Gd, Gd, Gd, Aa^Fpa, Re, Gd, Gd, Gll^Fp, Aa^Fpa, Gd, Gd, Aa, Aa, Aa, Aa, Gd, Aa^Fpa, Aa^Vha, Aa^Fpa, Gd, Aa, Aa, Aa, Aa, Gd, Gd, Aa, Aa, Aa, Gd, Ww, Ww, Ww, Gd, Aa, Aa, Aa
Aa, Aa, Gd, Aa^Fpa, Gll^Fp, Gll^Fp, Gd, Gll^Fp, Gll^Fp, Re, Gd, Gd, Gll^Fp, Aa^Fpa, Gd, Aa^Vha, Aa, Aa, Aa, Gd, Aa^Fpa, Aa^Fpa, Aa^Fpa, Aa^Fpa, Gd^Vh, Gd, Aa, Aa, Aa, Gd, Gd, Gd, Aa, Ai, Ww, Ww, Ww, Aa^Fpa, Aa^Fpa, Gd, Aa, Aa
Aa, Gd, Aa^Fpa, Gll^Fp, Gll^Fp, Gll^Fp, Gll^Fp, Gll^Fp, Gll^Fp, Re, Gd, Gll^Fp, Gll^Fp, Aa^Fpa, Gd, Aa, Aa, Aa, Aa, Gd, Gll^Fp, Gll^Fp, Gll^Fp, Gll^Fp, Gd, Gd, Aa, Aa, Aa, Aa, Gd, Aa, Ai, Ww, Ww, Ww, Ww, Aa^Fpa, Gll^Fp, Gd, Aa, Aa
